student_id,math_p1,math_p2,Total_Math, percentange_maths ,eng_p1,eng_p2,eng_p3,Total_english, English_Percentage ,kisw_p1,kisw_p2,kisw_p3,Total_marks_swahili, Kiswahili_Percentage ,chem_p1,chem_p2,chem_p3,Total_Chem, Chem_Percentage ,bio_p1,bio_p2,bio_p3,Total Bio, Bology_Percentage ,phy_p1,phy_p2,phy_p3,Total_Phy, Physics_Percentage ,Total_marks, Total_percentage ,learning_style,self_assessment,recommendations
ST-001,83,73,156, 0.78 ,33,75,60,168, 0.84 ,57,52,25,134, 0.67 ,76,38,28,142, 0.71 ,63,47,33,143, 0.72 ,49,60,31,140, 0.70 ,883, 0.74 ,kinesthetic,2,Join study group
ST-002,98,51,149, 0.75 ,22,65,57,144, 0.72 ,23,69,55,147, 0.74 ,20,52,20,92, 0.46 ,28,59,30,117, 0.59 ,20,40,25,85, 0.43 ,734, 0.61 ,kinesthetic,2,Study more
ST-003,47,62,109, 0.55 ,53,46,45,144, 0.72 ,30,63,56,149, 0.75 ,33,30,27,90, 0.45 ,64,66,21,151, 0.76 ,36,33,38,107, 0.54 ,750, 0.63 ,kinesthetic,1,Practice regularly
ST-004,23,21,44, 0.22 ,28,58,63,149, 0.75 ,29,20,33,82, 0.41 ,66,57,39,162, 0.81 ,52,56,33,141, 0.71 ,56,55,38,149, 0.75 ,727, 0.61 ,auditory,3,Ask questions
ST-005,45,24,69, 0.35 ,36,38,78,152, 0.76 ,35,59,57,151, 0.76 ,34,61,33,128, 0.64 ,53,37,28,118, 0.59 ,77,37,27,141, 0.71 ,759, 0.63 ,kinesthetic,5,Study more
ST-006,66,49,115, 0.58 ,40,48,70,158, 0.79 ,40,38,47,125, 0.63 ,32,22,28,82, 0.41 ,44,61,26,131, 0.66 ,27,65,24,116, 0.58 ,727, 0.61 ,visual,2,Join study group
ST-007,80,71,151, 0.76 ,22,36,63,121, 0.61 ,33,60,40,133, 0.67 ,78,40,35,153, 0.77 ,58,70,36,164, 0.82 ,33,73,22,128, 0.64 ,850, 0.71 ,kinesthetic,3,Join study group
ST-008,49,89,138, 0.69 ,58,42,77,177, 0.89 ,27,60,25,112, 0.56 ,22,59,36,117, 0.59 ,43,20,31,94, 0.47 ,42,25,28,95, 0.48 ,733, 0.61 ,kinesthetic,2,Join study group
ST-009,89,21,110, 0.55 ,33,34,44,111, 0.56 ,47,31,64,142, 0.71 ,48,42,25,115, 0.58 ,61,23,27,111, 0.56 ,65,27,30,122, 0.61 ,711, 0.59 ,visual,3,Practice regularly
ST-010,86,68,154, 0.77 ,25,76,78,179, 0.90 ,26,79,44,149, 0.75 ,37,50,38,125, 0.63 ,31,66,37,134, 0.67 ,68,63,35,166, 0.83 ,907, 0.76 ,visual,3,Study more
ST-011,87,40,127, 0.64 ,48,62,45,155, 0.78 ,22,25,53,100, 0.50 ,47,68,37,152, 0.76 ,44,77,22,143, 0.72 ,67,20,37,124, 0.62 ,801, 0.67 ,auditory,4,Study more
ST-012,68,51,119, 0.60 ,32,68,34,134, 0.67 ,49,78,22,149, 0.75 ,59,55,25,139, 0.70 ,25,40,31,96, 0.48 ,56,53,26,135, 0.68 ,772, 0.64 ,visual,3,Practice regularly
ST-013,82,82,164, 0.82 ,35,27,22,84, 0.42 ,52,67,53,172, 0.86 ,62,23,36,121, 0.61 ,35,64,37,136, 0.68 ,68,42,31,141, 0.71 ,818, 0.68 ,visual,3,Study more
ST-014,81,40,121, 0.61 ,37,30,23,90, 0.45 ,45,77,52,174, 0.87 ,73,62,34,169, 0.85 ,76,71,37,184, 0.92 ,61,64,25,150, 0.75 ,888, 0.74 ,kinesthetic,3,Study more
ST-015,62,74,136, 0.68 ,37,67,49,153, 0.77 ,55,35,23,113, 0.57 ,33,29,26,88, 0.44 ,79,75,28,182, 0.91 ,71,36,39,146, 0.73 ,818, 0.68 ,kinesthetic,1,Study more
ST-016,35,93,128, 0.64 ,26,67,43,136, 0.68 ,56,22,70,148, 0.74 ,76,32,27,135, 0.68 ,26,74,30,130, 0.65 ,29,28,26,83, 0.42 ,760, 0.63 ,kinesthetic,1,Study more
ST-017,93,63,156, 0.78 ,48,78,44,170, 0.85 ,57,60,60,177, 0.89 ,23,44,21,88, 0.44 ,70,76,21,167, 0.84 ,76,34,23,133, 0.67 ,891, 0.74 ,kinesthetic,2,Ask questions
ST-018,65,97,162, 0.81 ,23,27,73,123, 0.62 ,32,66,29,127, 0.64 ,58,64,21,143, 0.72 ,29,56,30,115, 0.58 ,35,37,26,98, 0.49 ,768, 0.64 ,visual,5,Join study group
ST-019,37,97,134, 0.67 ,38,65,46,149, 0.75 ,57,69,32,158, 0.79 ,21,43,30,94, 0.47 ,23,22,38,83, 0.42 ,63,77,27,167, 0.84 ,785, 0.65 ,visual,2,Study more
ST-020,69,37,106, 0.53 ,58,44,75,177, 0.89 ,24,35,79,138, 0.69 ,44,26,27,97, 0.49 ,61,52,39,152, 0.76 ,66,56,37,159, 0.80 ,829, 0.69 ,kinesthetic,3,Ask questions
ST-021,20,52,72, 0.36 ,45,61,62,168, 0.84 ,28,70,37,135, 0.68 ,63,35,27,125, 0.63 ,31,44,39,114, 0.57 ,34,22,33,89, 0.45 ,703, 0.59 ,kinesthetic,3,Practice regularly
ST-022,28,81,109, 0.55 ,24,69,23,116, 0.58 ,51,70,74,195, 0.98 ,32,25,39,96, 0.48 ,69,76,31,176, 0.88 ,66,33,20,119, 0.60 ,811, 0.68 ,auditory,2,Join study group
ST-023,34,99,133, 0.67 ,53,32,71,156, 0.78 ,35,57,72,164, 0.82 ,33,55,23,111, 0.56 ,68,79,24,171, 0.86 ,69,25,34,128, 0.64 ,863, 0.72 ,auditory,2,Study more
ST-024,29,97,126, 0.63 ,40,57,54,151, 0.76 ,48,62,64,174, 0.87 ,36,63,28,127, 0.64 ,69,35,30,134, 0.67 ,70,66,30,166, 0.83 ,878, 0.73 ,kinesthetic,4,Practice regularly
ST-025,43,37,80, 0.40 ,43,73,66,182, 0.91 ,27,20,44,91, 0.46 ,46,58,37,141, 0.71 ,59,76,27,162, 0.81 ,49,78,36,163, 0.82 ,819, 0.68 ,kinesthetic,3,Study more
ST-026,90,91,181, 0.91 ,31,44,47,122, 0.61 ,28,42,63,133, 0.67 ,50,43,20,113, 0.57 ,49,30,28,107, 0.54 ,29,33,27,89, 0.45 ,745, 0.62 ,visual,3,Study more
ST-027,72,90,162, 0.81 ,30,48,67,145, 0.73 ,59,51,65,175, 0.88 ,60,57,33,150, 0.75 ,22,28,31,81, 0.41 ,28,66,29,123, 0.62 ,836, 0.70 ,auditory,5,Practice regularly
ST-028,32,21,53, 0.27 ,48,65,64,177, 0.89 ,59,25,30,114, 0.57 ,40,46,22,108, 0.54 ,68,54,31,153, 0.77 ,56,44,31,131, 0.66 ,736, 0.61 ,auditory,2,Study more
ST-029,61,80,141, 0.71 ,50,41,65,156, 0.78 ,50,47,31,128, 0.64 ,54,20,35,109, 0.55 ,70,28,37,135, 0.68 ,33,69,21,123, 0.62 ,792, 0.66 ,visual,5,Practice regularly
ST-030,33,29,62, 0.31 ,24,60,30,114, 0.57 ,43,74,26,143, 0.72 ,42,45,31,118, 0.59 ,52,42,34,128, 0.64 ,41,40,23,104, 0.52 ,669, 0.56 ,auditory,5,Practice regularly
ST-031,63,87,150, 0.75 ,54,53,38,145, 0.73 ,43,65,31,139, 0.70 ,33,20,25,78, 0.39 ,44,20,28,92, 0.46 ,45,51,37,133, 0.67 ,737, 0.61 ,visual,4,Practice regularly
ST-032,45,83,128, 0.64 ,47,50,49,146, 0.73 ,40,74,71,185, 0.93 ,28,67,34,129, 0.65 ,62,55,33,150, 0.75 ,76,20,38,134, 0.67 ,872, 0.73 ,kinesthetic,5,Study more
ST-033,66,94,160, 0.80 ,54,52,62,168, 0.84 ,25,43,38,106, 0.53 ,73,60,36,169, 0.85 ,62,59,28,149, 0.75 ,62,41,31,134, 0.67 ,886, 0.74 ,auditory,3,Ask questions
ST-034,69,28,97, 0.49 ,55,61,57,173, 0.87 ,27,56,41,124, 0.62 ,22,66,20,108, 0.54 ,47,44,20,111, 0.56 ,21,27,39,87, 0.44 ,700, 0.58 ,auditory,1,Study more
ST-035,22,85,107, 0.54 ,54,48,28,130, 0.65 ,56,22,66,144, 0.72 ,23,43,32,98, 0.49 ,44,34,36,114, 0.57 ,74,35,37,146, 0.73 ,739, 0.62 ,auditory,3,Study more
ST-036,82,48,130, 0.65 ,58,67,57,182, 0.91 ,24,39,31,94, 0.47 ,40,42,30,112, 0.56 ,59,26,27,112, 0.56 ,36,65,31,132, 0.66 ,762, 0.64 ,kinesthetic,3,Practice regularly
ST-037,54,57,111, 0.56 ,47,29,75,151, 0.76 ,26,40,72,138, 0.69 ,27,39,32,98, 0.49 ,37,35,21,93, 0.47 ,77,38,36,151, 0.76 ,742, 0.62 ,visual,2,Ask questions
ST-038,82,85,167, 0.84 ,44,59,47,150, 0.75 ,58,60,51,169, 0.85 ,24,52,35,111, 0.56 ,31,33,38,102, 0.51 ,79,50,24,153, 0.77 ,852, 0.71 ,auditory,5,Study more
ST-039,39,37,76, 0.38 ,41,40,75,156, 0.78 ,22,21,40,83, 0.42 ,79,45,35,159, 0.80 ,73,74,21,168, 0.84 ,30,75,39,144, 0.72 ,786, 0.66 ,visual,1,Join study group
ST-040,29,89,118, 0.59 ,20,38,63,121, 0.61 ,26,37,61,124, 0.62 ,67,28,26,121, 0.61 ,67,26,32,125, 0.63 ,33,54,38,125, 0.63 ,734, 0.61 ,kinesthetic,3,Practice regularly
ST-041,60,96,156, 0.78 ,52,45,70,167, 0.84 ,27,63,32,122, 0.61 ,34,70,20,124, 0.62 ,53,69,35,157, 0.79 ,74,55,37,166, 0.83 ,892, 0.74 ,kinesthetic,3,Practice regularly
ST-042,33,20,53, 0.27 ,23,36,78,137, 0.69 ,37,22,24,83, 0.42 ,22,66,25,113, 0.57 ,28,78,29,135, 0.68 ,46,65,26,137, 0.69 ,658, 0.55 ,visual,5,Study more
ST-043,82,31,113, 0.57 ,45,72,36,153, 0.77 ,33,62,26,121, 0.61 ,75,79,20,174, 0.87 ,61,24,27,112, 0.56 ,40,28,24,92, 0.46 ,765, 0.64 ,visual,1,Study more
ST-044,72,84,156, 0.78 ,39,58,49,146, 0.73 ,35,45,22,102, 0.51 ,64,57,21,142, 0.71 ,57,36,30,123, 0.62 ,31,53,28,112, 0.56 ,781, 0.65 ,visual,4,Practice regularly
ST-045,58,49,107, 0.54 ,40,44,21,105, 0.53 ,57,46,77,180, 0.90 ,38,62,23,123, 0.62 ,22,73,28,123, 0.62 ,22,48,32,102, 0.51 ,740, 0.62 ,auditory,1,Study more
ST-046,46,93,139, 0.70 ,36,63,46,145, 0.73 ,57,23,50,130, 0.65 ,35,22,27,84, 0.42 ,33,78,24,135, 0.68 ,28,22,26,76, 0.38 ,709, 0.59 ,auditory,2,Join study group
ST-047,86,67,153, 0.77 ,54,23,62,139, 0.70 ,27,68,56,151, 0.76 ,66,51,35,152, 0.76 ,43,68,21,132, 0.66 ,21,69,23,113, 0.57 ,840, 0.70 ,auditory,1,Ask questions
ST-048,59,76,135, 0.68 ,22,45,33,100, 0.50 ,27,30,44,101, 0.51 ,55,77,22,154, 0.77 ,51,29,35,115, 0.58 ,67,21,38,126, 0.63 ,731, 0.61 ,kinesthetic,2,Join study group
ST-049,96,62,158, 0.79 ,56,23,75,154, 0.77 ,37,75,39,151, 0.76 ,70,49,27,146, 0.73 ,25,71,37,133, 0.67 ,61,52,24,137, 0.69 ,879, 0.73 ,auditory,4,Practice regularly
ST-050,21,27,48, 0.24 ,41,31,78,150, 0.75 ,41,24,25,90, 0.45 ,65,66,23,154, 0.77 ,37,69,25,131, 0.66 ,59,24,36,119, 0.60 ,692, 0.58 ,auditory,2,Ask questions
ST-051,93,44,137, 0.69 ,42,65,78,185, 0.93 ,20,34,47,101, 0.51 ,34,68,31,133, 0.67 ,43,45,26,114, 0.57 ,72,44,33,149, 0.75 ,819, 0.68 ,kinesthetic,4,Practice regularly
ST-052,32,22,54, 0.27 ,55,38,52,145, 0.73 ,58,51,58,167, 0.84 ,63,26,22,111, 0.56 ,23,56,33,112, 0.56 ,46,28,32,106, 0.53 ,695, 0.58 ,visual,3,Practice regularly
ST-053,44,82,126, 0.63 ,54,27,29,110, 0.55 ,57,71,59,187, 0.94 ,20,25,30,75, 0.38 ,75,52,35,162, 0.81 ,36,73,25,134, 0.67 ,794, 0.66 ,kinesthetic,4,Practice regularly
ST-054,26,90,116, 0.58 ,32,22,68,122, 0.61 ,56,66,58,180, 0.90 ,22,22,26,70, 0.35 ,55,23,25,103, 0.52 ,60,74,29,163, 0.82 ,754, 0.63 ,auditory,5,Practice regularly
ST-055,65,95,160, 0.80 ,31,72,77,180, 0.90 ,29,75,52,156, 0.78 ,22,47,26,95, 0.48 ,66,48,39,153, 0.77 ,67,47,26,140, 0.70 ,884, 0.74 ,kinesthetic,2,Join study group
ST-056,77,63,140, 0.70 ,39,32,47,118, 0.59 ,52,25,50,127, 0.64 ,32,53,23,108, 0.54 ,38,61,30,129, 0.65 ,38,42,27,107, 0.54 ,729, 0.61 ,kinesthetic,1,Join study group
ST-057,36,39,75, 0.38 ,54,34,38,126, 0.63 ,59,22,39,120, 0.60 ,68,71,24,163, 0.82 ,21,69,38,128, 0.64 ,77,49,25,151, 0.76 ,763, 0.64 ,kinesthetic,5,Ask questions
ST-058,25,25,50, 0.25 ,37,30,49,116, 0.58 ,40,71,69,180, 0.90 ,73,74,30,177, 0.89 ,66,29,25,120, 0.60 ,23,54,34,111, 0.56 ,754, 0.63 ,auditory,5,Ask questions
ST-059,37,89,126, 0.63 ,55,57,24,136, 0.68 ,55,64,41,160, 0.80 ,38,76,29,143, 0.72 ,72,59,28,159, 0.80 ,24,24,38,86, 0.43 ,810, 0.68 ,kinesthetic,2,Join study group
ST-060,91,86,177, 0.89 ,46,22,58,126, 0.63 ,52,37,32,121, 0.61 ,20,41,22,83, 0.42 ,41,73,36,150, 0.75 ,63,21,34,118, 0.59 ,775, 0.65 ,kinesthetic,3,Study more
ST-061,30,53,83, 0.42 ,47,35,54,136, 0.68 ,24,56,63,143, 0.72 ,40,48,38,126, 0.63 ,76,51,38,165, 0.83 ,52,25,24,101, 0.51 ,754, 0.63 ,visual,3,Study more
ST-062,88,85,173, 0.87 ,28,64,60,152, 0.76 ,46,53,54,153, 0.77 ,31,35,27,93, 0.47 ,79,56,22,157, 0.79 ,55,53,29,137, 0.69 ,865, 0.72 ,auditory,1,Ask questions
ST-063,88,32,120, 0.60 ,50,51,64,165, 0.83 ,54,65,70,189, 0.95 ,21,40,35,96, 0.48 ,49,54,31,134, 0.67 ,37,48,25,110, 0.55 ,814, 0.68 ,visual,5,Join study group
ST-064,38,87,125, 0.63 ,26,41,30,97, 0.49 ,53,75,68,196, 0.98 ,26,37,31,94, 0.47 ,69,46,31,146, 0.73 ,27,63,36,126, 0.63 ,784, 0.65 ,kinesthetic,1,Practice regularly
ST-065,98,69,167, 0.84 ,36,29,79,144, 0.72 ,55,45,65,165, 0.83 ,62,39,36,137, 0.69 ,41,77,30,148, 0.74 ,28,66,24,118, 0.59 ,879, 0.73 ,kinesthetic,1,Ask questions
ST-066,73,57,130, 0.65 ,54,49,68,171, 0.86 ,44,70,43,157, 0.79 ,38,65,22,125, 0.63 ,50,70,26,146, 0.73 ,76,58,33,167, 0.84 ,896, 0.75 ,kinesthetic,3,Ask questions
ST-067,49,98,147, 0.74 ,31,73,79,183, 0.92 ,34,61,75,170, 0.85 ,73,28,23,124, 0.62 ,63,56,35,154, 0.77 ,72,78,28,178, 0.89 ,956, 0.80 ,kinesthetic,2,Join study group
ST-068,83,66,149, 0.75 ,47,67,73,187, 0.94 ,41,63,40,144, 0.72 ,63,67,39,169, 0.85 ,75,68,31,174, 0.87 ,55,48,25,128, 0.64 ,951, 0.79 ,kinesthetic,1,Practice regularly
ST-069,82,97,179, 0.90 ,36,59,63,158, 0.79 ,57,29,22,108, 0.54 ,48,66,34,148, 0.74 ,75,51,32,158, 0.79 ,33,76,20,129, 0.65 ,880, 0.73 ,visual,5,Join study group
ST-070,53,73,126, 0.63 ,59,78,36,173, 0.87 ,34,77,35,146, 0.73 ,57,62,38,157, 0.79 ,62,23,21,106, 0.53 ,37,34,37,108, 0.54 ,816, 0.68 ,kinesthetic,3,Join study group
ST-071,64,47,111, 0.56 ,53,67,72,192, 0.96 ,21,24,59,104, 0.52 ,54,52,39,145, 0.73 ,57,69,36,162, 0.81 ,65,22,36,123, 0.62 ,837, 0.70 ,visual,5,Study more
ST-072,79,20,99, 0.50 ,33,29,60,122, 0.61 ,56,45,27,128, 0.64 ,49,58,30,137, 0.69 ,29,37,24,90, 0.45 ,45,32,39,116, 0.58 ,692, 0.58 ,visual,5,Study more
ST-073,82,63,145, 0.73 ,35,50,68,153, 0.77 ,26,24,75,125, 0.63 ,28,70,32,130, 0.65 ,68,26,28,122, 0.61 ,22,51,22,95, 0.48 ,770, 0.64 ,visual,3,Ask questions
ST-074,63,22,85, 0.43 ,50,64,78,192, 0.96 ,45,69,46,160, 0.80 ,36,61,38,135, 0.68 ,33,67,35,135, 0.68 ,48,73,35,156, 0.78 ,863, 0.72 ,auditory,2,Ask questions
ST-075,84,23,107, 0.54 ,45,74,33,152, 0.76 ,28,35,29,92, 0.46 ,49,60,23,132, 0.66 ,75,44,32,151, 0.76 ,46,72,24,142, 0.71 ,776, 0.65 ,kinesthetic,4,Study more
ST-076,95,57,152, 0.76 ,29,29,31,89, 0.45 ,26,27,67,120, 0.60 ,33,49,31,113, 0.57 ,27,20,27,74, 0.37 ,41,34,27,102, 0.51 ,650, 0.54 ,kinesthetic,5,Study more
ST-077,37,30,67, 0.34 ,36,36,75,147, 0.74 ,40,57,52,149, 0.75 ,60,67,36,163, 0.82 ,71,42,35,148, 0.74 ,45,49,21,115, 0.58 ,789, 0.66 ,auditory,5,Join study group
ST-078,52,89,141, 0.71 ,34,46,73,153, 0.77 ,56,31,62,149, 0.75 ,78,70,20,168, 0.84 ,52,55,36,143, 0.72 ,79,67,37,183, 0.92 ,937, 0.78 ,visual,2,Practice regularly
ST-079,99,35,134, 0.67 ,55,48,70,173, 0.87 ,45,44,61,150, 0.75 ,38,73,31,142, 0.71 ,73,65,31,169, 0.85 ,48,42,37,127, 0.64 ,895, 0.75 ,visual,3,Ask questions
ST-080,92,98,190, 0.95 ,49,66,41,156, 0.78 ,54,30,76,160, 0.80 ,48,28,38,114, 0.57 ,33,63,26,122, 0.61 ,71,67,31,169, 0.85 ,911, 0.76 ,auditory,1,Study more
ST-081,81,69,150, 0.75 ,31,35,35,101, 0.51 ,57,32,62,151, 0.76 ,25,26,30,81, 0.41 ,54,26,39,119, 0.60 ,68,76,35,179, 0.90 ,781, 0.65 ,auditory,3,Practice regularly
ST-082,76,36,112, 0.56 ,28,74,76,178, 0.89 ,53,68,72,193, 0.97 ,71,53,21,145, 0.73 ,34,33,25,92, 0.46 ,66,69,30,165, 0.83 ,885, 0.74 ,visual,3,Practice regularly
ST-083,57,94,151, 0.76 ,34,68,46,148, 0.74 ,38,72,69,179, 0.90 ,52,23,20,95, 0.48 ,69,26,33,128, 0.64 ,48,20,23,91, 0.46 ,792, 0.66 ,visual,2,Practice regularly
ST-084,88,97,185, 0.93 ,22,76,23,121, 0.61 ,36,36,58,130, 0.65 ,53,65,27,145, 0.73 ,63,56,29,148, 0.74 ,50,42,28,120, 0.60 ,849, 0.71 ,auditory,1,Join study group
ST-085,66,68,134, 0.67 ,38,73,26,137, 0.69 ,42,22,76,140, 0.70 ,77,36,28,141, 0.71 ,44,20,35,99, 0.50 ,24,24,34,82, 0.41 ,733, 0.61 ,auditory,4,Ask questions
ST-086,25,23,48, 0.24 ,54,26,79,159, 0.80 ,41,76,73,190, 0.95 ,32,42,37,111, 0.56 ,66,39,26,131, 0.66 ,79,39,35,153, 0.77 ,792, 0.66 ,visual,3,Join study group
ST-087,99,36,135, 0.68 ,59,53,39,151, 0.76 ,25,20,23,68, 0.34 ,59,45,29,133, 0.67 ,46,68,26,140, 0.70 ,68,40,32,140, 0.70 ,767, 0.64 ,kinesthetic,1,Ask questions
ST-088,52,24,76, 0.38 ,42,40,27,109, 0.55 ,43,79,51,173, 0.87 ,48,23,28,99, 0.50 ,77,60,23,160, 0.80 ,64,57,23,144, 0.72 ,761, 0.63 ,auditory,2,Ask questions
ST-089,40,61,101, 0.51 ,25,55,72,152, 0.76 ,31,38,34,103, 0.52 ,38,52,24,114, 0.57 ,23,74,31,128, 0.64 ,70,70,20,160, 0.80 ,758, 0.63 ,kinesthetic,3,Practice regularly
ST-090,74,92,166, 0.83 ,37,56,54,147, 0.74 ,37,41,45,123, 0.62 ,55,68,28,151, 0.76 ,20,32,31,83, 0.42 ,26,67,38,131, 0.66 ,801, 0.67 ,auditory,2,Ask questions
ST-091,47,40,87, 0.44 ,52,37,46,135, 0.68 ,29,45,43,117, 0.59 ,73,47,36,156, 0.78 ,75,64,37,176, 0.88 ,26,35,39,100, 0.50 ,771, 0.64 ,visual,2,Practice regularly
ST-092,28,97,125, 0.63 ,25,37,41,103, 0.52 ,48,24,49,121, 0.61 ,37,74,21,132, 0.66 ,71,40,22,133, 0.67 ,33,58,34,125, 0.63 ,739, 0.62 ,kinesthetic,4,Study more
ST-093,26,84,110, 0.55 ,58,28,52,138, 0.69 ,49,58,38,145, 0.73 ,23,48,25,96, 0.48 ,54,68,38,160, 0.80 ,28,45,28,101, 0.51 ,750, 0.63 ,kinesthetic,4,Join study group
ST-094,36,26,62, 0.31 ,42,21,48,111, 0.56 ,58,33,23,114, 0.57 ,37,59,36,132, 0.66 ,42,45,39,126, 0.63 ,36,54,33,123, 0.62 ,668, 0.56 ,visual,3,Study more
ST-095,66,52,118, 0.59 ,43,64,48,155, 0.78 ,50,75,60,185, 0.93 ,56,70,20,146, 0.73 ,51,77,25,153, 0.77 ,23,79,37,139, 0.70 ,896, 0.75 ,kinesthetic,1,Practice regularly
ST-096,45,80,125, 0.63 ,50,49,48,147, 0.74 ,51,52,37,140, 0.70 ,27,29,24,80, 0.40 ,40,64,25,129, 0.65 ,66,77,22,165, 0.83 ,786, 0.66 ,kinesthetic,4,Join study group
ST-097,88,71,159, 0.80 ,35,78,63,176, 0.88 ,47,30,75,152, 0.76 ,54,69,22,145, 0.73 ,35,39,24,98, 0.49 ,49,37,28,114, 0.57 ,844, 0.70 ,auditory,5,Practice regularly
ST-098,98,87,185, 0.93 ,42,76,63,181, 0.91 ,40,26,70,136, 0.68 ,27,68,31,126, 0.63 ,75,53,22,150, 0.75 ,52,27,29,108, 0.54 ,886, 0.74 ,kinesthetic,3,Ask questions
ST-099,37,75,112, 0.56 ,42,59,72,173, 0.87 ,38,62,69,169, 0.85 ,43,59,24,126, 0.63 ,54,58,25,137, 0.69 ,53,42,28,123, 0.62 ,840, 0.70 ,auditory,5,Study more
ST-100,82,57,139, 0.70 ,56,69,29,154, 0.77 ,36,42,67,145, 0.73 ,65,21,29,115, 0.58 ,73,79,31,183, 0.92 ,52,42,24,118, 0.59 ,854, 0.71 ,visual,4,Ask questions
ST-101,46,67,113, 0.57 ,54,36,51,141, 0.71 ,24,55,38,117, 0.59 ,54,41,22,117, 0.59 ,68,68,24,160, 0.80 ,76,22,22,120, 0.60 ,768, 0.64 ,kinesthetic,2,Ask questions
ST-102,25,30,55, 0.28 ,24,38,43,105, 0.53 ,47,56,36,139, 0.70 ,54,37,24,115, 0.58 ,50,56,33,139, 0.70 ,58,56,24,138, 0.69 ,691, 0.58 ,visual,5,Ask questions
ST-103,41,50,91, 0.46 ,42,38,31,111, 0.56 ,37,39,35,111, 0.56 ,48,54,22,124, 0.62 ,68,47,28,143, 0.72 ,27,57,23,107, 0.54 ,687, 0.57 ,auditory,5,Study more
ST-104,61,92,153, 0.77 ,33,75,53,161, 0.81 ,32,62,26,120, 0.60 ,51,54,30,135, 0.68 ,31,57,31,119, 0.60 ,49,44,31,124, 0.62 ,812, 0.68 ,auditory,4,Study more
ST-105,28,57,85, 0.43 ,46,79,22,147, 0.74 ,25,36,76,137, 0.69 ,36,60,32,128, 0.64 ,64,75,28,167, 0.84 ,57,51,37,145, 0.73 ,809, 0.67 ,kinesthetic,4,Ask questions
ST-106,22,32,54, 0.27 ,45,20,36,101, 0.51 ,24,31,22,77, 0.39 ,23,38,26,87, 0.44 ,59,63,27,149, 0.75 ,43,46,37,126, 0.63 ,594, 0.50 ,visual,2,Ask questions
ST-107,68,72,140, 0.70 ,31,77,67,175, 0.88 ,41,32,47,120, 0.60 ,31,67,35,133, 0.67 ,74,48,30,152, 0.76 ,21,77,20,118, 0.59 ,838, 0.70 ,visual,4,Practice regularly
ST-108,49,51,100, 0.50 ,32,62,65,159, 0.80 ,53,30,72,155, 0.78 ,33,32,24,89, 0.45 ,49,56,24,129, 0.65 ,44,74,21,139, 0.70 ,771, 0.64 ,visual,2,Practice regularly
ST-109,36,65,101, 0.51 ,33,59,26,118, 0.59 ,48,20,35,103, 0.52 ,28,54,25,107, 0.54 ,65,71,26,162, 0.81 ,79,79,34,192, 0.96 ,783, 0.65 ,kinesthetic,5,Ask questions
ST-110,27,31,58, 0.29 ,28,56,67,151, 0.76 ,51,22,23,96, 0.48 ,36,26,30,92, 0.46 ,40,28,29,97, 0.49 ,46,52,34,132, 0.66 ,626, 0.52 ,auditory,3,Ask questions
ST-111,34,23,57, 0.29 ,29,28,28,85, 0.43 ,48,71,75,194, 0.97 ,62,21,22,105, 0.53 ,72,30,39,141, 0.71 ,72,57,28,157, 0.79 ,739, 0.62 ,kinesthetic,1,Practice regularly
ST-112,20,85,105, 0.53 ,36,78,35,149, 0.75 ,29,35,38,102, 0.51 ,50,61,25,136, 0.68 ,60,51,34,145, 0.73 ,38,73,29,140, 0.70 ,777, 0.65 ,visual,3,Practice regularly
ST-113,32,26,58, 0.29 ,29,63,79,171, 0.86 ,59,31,58,148, 0.74 ,64,67,26,157, 0.79 ,69,58,26,153, 0.77 ,79,65,37,181, 0.91 ,868, 0.72 ,auditory,5,Study more
ST-114,99,44,143, 0.72 ,37,29,33,99, 0.50 ,20,58,40,118, 0.59 ,32,31,34,97, 0.49 ,62,56,28,146, 0.73 ,47,23,24,94, 0.47 ,697, 0.58 ,kinesthetic,1,Practice regularly
ST-115,72,23,95, 0.48 ,53,45,59,157, 0.79 ,21,56,47,124, 0.62 ,69,47,36,152, 0.76 ,24,77,31,132, 0.66 ,38,36,36,110, 0.55 ,770, 0.64 ,visual,1,Ask questions
ST-116,70,32,102, 0.51 ,47,74,26,147, 0.74 ,53,44,40,137, 0.69 ,78,60,30,168, 0.84 ,49,76,34,159, 0.80 ,52,56,29,137, 0.69 ,850, 0.71 ,visual,1,Join study group
ST-117,89,69,158, 0.79 ,43,25,41,109, 0.55 ,55,57,72,184, 0.92 ,73,54,24,151, 0.76 ,26,36,25,87, 0.44 ,33,33,37,103, 0.52 ,792, 0.66 ,visual,3,Practice regularly
ST-118,69,69,138, 0.69 ,26,73,66,165, 0.83 ,52,71,61,184, 0.92 ,72,24,30,126, 0.63 ,65,26,25,116, 0.58 ,20,76,35,131, 0.66 ,860, 0.72 ,kinesthetic,4,Practice regularly
ST-119,95,59,154, 0.77 ,34,69,37,140, 0.70 ,58,47,59,164, 0.82 ,43,39,29,111, 0.56 ,48,70,33,151, 0.76 ,41,69,32,142, 0.71 ,862, 0.72 ,visual,1,Study more
ST-120,93,24,117, 0.59 ,44,72,57,173, 0.87 ,37,35,29,101, 0.51 ,38,63,33,134, 0.67 ,31,46,23,100, 0.50 ,48,23,39,110, 0.55 ,735, 0.61 ,visual,1,Ask questions
ST-121,70,31,101, 0.51 ,48,50,36,134, 0.67 ,24,33,49,106, 0.53 ,26,46,23,95, 0.48 ,51,38,24,113, 0.57 ,69,38,21,128, 0.64 ,677, 0.56 ,kinesthetic,1,Practice regularly
ST-122,61,94,155, 0.78 ,55,29,30,114, 0.57 ,46,20,36,102, 0.51 ,29,30,23,82, 0.41 ,39,50,30,119, 0.60 ,64,56,34,154, 0.77 ,726, 0.61 ,kinesthetic,4,Join study group
ST-123,30,36,66, 0.33 ,58,37,76,171, 0.86 ,41,68,51,160, 0.80 ,28,71,36,135, 0.68 ,65,36,27,128, 0.64 ,43,51,28,122, 0.61 ,782, 0.65 ,visual,2,Practice regularly
ST-124,73,26,99, 0.50 ,22,22,63,107, 0.54 ,43,50,29,122, 0.61 ,20,22,20,62, 0.31 ,34,49,38,121, 0.61 ,37,53,30,120, 0.60 ,631, 0.53 ,auditory,3,Ask questions
ST-125,81,34,115, 0.58 ,55,60,55,170, 0.85 ,29,64,58,151, 0.76 ,53,59,28,140, 0.70 ,30,77,36,143, 0.72 ,60,39,32,131, 0.66 ,850, 0.71 ,visual,1,Join study group
ST-126,64,84,148, 0.74 ,36,76,27,139, 0.70 ,59,21,23,103, 0.52 ,35,66,21,122, 0.61 ,67,33,20,120, 0.60 ,20,34,28,82, 0.41 ,714, 0.60 ,kinesthetic,5,Study more
ST-127,73,93,166, 0.83 ,36,46,44,126, 0.63 ,40,75,37,152, 0.76 ,62,26,32,120, 0.60 ,58,26,24,108, 0.54 ,37,51,23,111, 0.56 ,783, 0.65 ,kinesthetic,2,Join study group
ST-128,41,69,110, 0.55 ,39,76,54,169, 0.85 ,47,70,25,142, 0.71 ,35,68,22,125, 0.63 ,69,63,25,157, 0.79 ,30,67,24,121, 0.61 ,824, 0.69 ,kinesthetic,1,Ask questions
ST-129,84,37,121, 0.61 ,50,54,35,139, 0.70 ,55,77,77,209, 1.05 ,24,50,27,101, 0.51 ,28,33,31,92, 0.46 ,44,40,32,116, 0.58 ,778, 0.65 ,auditory,4,Join study group
ST-130,96,75,171, 0.86 ,28,59,60,147, 0.74 ,53,29,72,154, 0.77 ,64,74,30,168, 0.84 ,63,79,29,171, 0.86 ,39,56,21,116, 0.58 ,927, 0.77 ,auditory,1,Practice regularly
ST-131,84,67,151, 0.76 ,44,51,30,125, 0.63 ,57,78,35,170, 0.85 ,77,32,24,133, 0.67 ,40,51,21,112, 0.56 ,67,62,25,154, 0.77 ,845, 0.70 ,visual,3,Practice regularly
ST-132,50,56,106, 0.53 ,39,76,38,153, 0.77 ,32,27,54,113, 0.57 ,55,45,26,126, 0.63 ,33,78,37,148, 0.74 ,27,30,25,82, 0.41 ,728, 0.61 ,auditory,5,Practice regularly
ST-133,48,91,139, 0.70 ,37,25,40,102, 0.51 ,48,59,52,159, 0.80 ,54,38,29,121, 0.61 ,68,21,28,117, 0.59 ,60,74,29,163, 0.82 ,801, 0.67 ,kinesthetic,4,Practice regularly
ST-134,56,46,102, 0.51 ,24,38,78,140, 0.70 ,26,39,65,130, 0.65 ,22,28,38,88, 0.44 ,63,20,22,105, 0.53 ,25,77,29,131, 0.66 ,696, 0.58 ,kinesthetic,5,Practice regularly
ST-135,35,61,96, 0.48 ,56,54,52,162, 0.81 ,43,57,44,144, 0.72 ,79,71,39,189, 0.95 ,54,35,34,123, 0.62 ,76,44,27,147, 0.74 ,861, 0.72 ,kinesthetic,2,Study more
ST-136,23,45,68, 0.34 ,55,60,34,149, 0.75 ,32,63,60,155, 0.78 ,42,42,39,123, 0.62 ,78,35,39,152, 0.76 ,47,24,29,100, 0.50 ,747, 0.62 ,kinesthetic,4,Study more
ST-137,20,30,50, 0.25 ,20,34,78,132, 0.66 ,58,44,25,127, 0.64 ,28,29,24,81, 0.41 ,36,41,32,109, 0.55 ,66,33,20,119, 0.60 ,618, 0.52 ,kinesthetic,5,Ask questions
ST-138,51,89,140, 0.70 ,35,72,38,145, 0.73 ,34,21,75,130, 0.65 ,51,52,30,133, 0.67 ,26,33,22,81, 0.41 ,67,76,23,166, 0.83 ,795, 0.66 ,visual,4,Study more
ST-139,59,64,123, 0.62 ,41,41,55,137, 0.69 ,59,63,58,180, 0.90 ,45,67,24,136, 0.68 ,34,70,27,131, 0.66 ,43,57,34,134, 0.67 ,841, 0.70 ,kinesthetic,3,Ask questions
ST-140,25,47,72, 0.36 ,31,68,73,172, 0.86 ,35,32,38,105, 0.53 ,39,34,27,100, 0.50 ,65,73,22,160, 0.80 ,62,29,23,114, 0.57 ,723, 0.60 ,visual,2,Study more
ST-141,21,36,57, 0.29 ,41,38,67,146, 0.73 ,55,47,79,181, 0.91 ,50,54,28,132, 0.66 ,30,60,22,112, 0.56 ,43,32,31,106, 0.53 ,734, 0.61 ,visual,4,Join study group
ST-142,88,54,142, 0.71 ,45,24,78,147, 0.74 ,54,67,71,192, 0.96 ,42,43,39,124, 0.62 ,53,45,36,134, 0.67 ,41,67,30,138, 0.69 ,877, 0.73 ,visual,5,Study more
ST-143,57,77,134, 0.67 ,24,75,76,175, 0.88 ,57,74,65,196, 0.98 ,44,51,37,132, 0.66 ,24,47,36,107, 0.54 ,62,46,36,144, 0.72 ,888, 0.74 ,auditory,4,Study more
ST-144,28,96,124, 0.62 ,34,35,22,91, 0.46 ,31,72,44,147, 0.74 ,65,25,26,116, 0.58 ,61,72,31,164, 0.82 ,57,39,35,131, 0.66 ,773, 0.64 ,visual,3,Ask questions
ST-145,42,49,91, 0.46 ,54,47,43,144, 0.72 ,48,66,55,169, 0.85 ,64,61,25,150, 0.75 ,40,75,25,140, 0.70 ,20,79,21,120, 0.60 ,814, 0.68 ,visual,4,Ask questions
ST-146,74,84,158, 0.79 ,53,39,75,167, 0.84 ,51,24,72,147, 0.74 ,41,64,34,139, 0.70 ,70,21,38,129, 0.65 ,63,78,31,172, 0.86 ,912, 0.76 ,visual,3,Study more
ST-147,53,47,100, 0.50 ,28,52,24,104, 0.52 ,32,21,35,88, 0.44 ,28,59,24,111, 0.56 ,49,69,37,155, 0.78 ,22,78,26,126, 0.63 ,684, 0.57 ,auditory,4,Study more
ST-148,99,84,183, 0.92 ,21,78,51,150, 0.75 ,57,60,59,176, 0.88 ,60,58,29,147, 0.74 ,55,75,38,168, 0.84 ,47,52,37,136, 0.68 ,960, 0.80 ,visual,2,Study more
ST-149,89,73,162, 0.81 ,30,45,31,106, 0.53 ,32,73,74,179, 0.90 ,64,64,37,165, 0.83 ,75,70,27,172, 0.86 ,46,29,33,108, 0.54 ,892, 0.74 ,auditory,1,Practice regularly
ST-150,71,48,119, 0.60 ,56,20,43,119, 0.60 ,39,36,65,140, 0.70 ,47,62,34,143, 0.72 ,28,70,33,131, 0.66 ,46,40,36,122, 0.61 ,774, 0.65 ,visual,3,Practice regularly
ST-151,51,28,79, 0.40 ,49,49,54,152, 0.76 ,29,33,49,111, 0.56 ,49,21,30,100, 0.50 ,72,35,25,132, 0.66 ,55,65,20,140, 0.70 ,714, 0.60 ,auditory,4,Ask questions
ST-152,71,24,95, 0.48 ,21,32,47,100, 0.50 ,45,74,69,188, 0.94 ,47,59,27,133, 0.67 ,27,45,36,108, 0.54 ,75,55,39,169, 0.85 ,793, 0.66 ,kinesthetic,4,Join study group
ST-153,58,61,119, 0.60 ,34,54,33,121, 0.61 ,48,62,58,168, 0.84 ,54,67,33,154, 0.77 ,78,43,22,143, 0.72 ,41,45,29,115, 0.58 ,820, 0.68 ,visual,3,Study more
ST-154,46,32,78, 0.39 ,57,34,25,116, 0.58 ,57,71,34,162, 0.81 ,50,22,32,104, 0.52 ,73,24,34,131, 0.66 ,33,31,30,94, 0.47 ,685, 0.57 ,auditory,2,Practice regularly
ST-155,80,76,156, 0.78 ,56,25,74,155, 0.78 ,44,62,78,184, 0.92 ,64,39,34,137, 0.69 ,63,47,26,136, 0.68 ,64,37,38,139, 0.70 ,907, 0.76 ,kinesthetic,2,Join study group
ST-156,64,26,90, 0.45 ,25,71,53,149, 0.75 ,57,40,34,131, 0.66 ,50,29,30,109, 0.55 ,38,55,23,116, 0.58 ,47,37,35,119, 0.60 ,714, 0.60 ,visual,1,Practice regularly
ST-157,76,50,126, 0.63 ,35,55,71,161, 0.81 ,35,47,25,107, 0.54 ,25,66,29,120, 0.60 ,31,66,23,120, 0.60 ,23,21,30,74, 0.37 ,708, 0.59 ,auditory,1,Practice regularly
ST-158,55,65,120, 0.60 ,51,58,34,143, 0.72 ,21,28,37,86, 0.43 ,55,47,22,124, 0.62 ,52,41,39,132, 0.66 ,67,38,34,139, 0.70 ,744, 0.62 ,auditory,2,Study more
ST-159,53,55,108, 0.54 ,39,62,61,162, 0.81 ,24,35,36,95, 0.48 ,40,49,22,111, 0.56 ,74,63,36,173, 0.87 ,65,21,37,123, 0.62 ,772, 0.64 ,auditory,3,Study more
ST-160,26,21,47, 0.24 ,34,43,20,97, 0.49 ,24,40,62,126, 0.63 ,75,45,27,147, 0.74 ,67,66,38,171, 0.86 ,21,42,29,92, 0.46 ,680, 0.57 ,visual,4,Ask questions
ST-161,65,80,145, 0.73 ,28,34,20,82, 0.41 ,42,65,70,177, 0.89 ,21,41,34,96, 0.48 ,42,42,30,114, 0.57 ,35,31,34,100, 0.50 ,714, 0.60 ,kinesthetic,2,Ask questions
ST-162,38,40,78, 0.39 ,29,51,41,121, 0.61 ,35,76,51,162, 0.81 ,24,43,27,94, 0.47 ,37,27,29,93, 0.47 ,35,75,38,148, 0.74 ,696, 0.58 ,auditory,4,Ask questions
ST-163,93,43,136, 0.68 ,35,58,48,141, 0.71 ,22,70,62,154, 0.77 ,61,45,24,130, 0.65 ,69,72,24,165, 0.83 ,69,24,27,120, 0.60 ,846, 0.71 ,visual,4,Practice regularly
ST-164,93,59,152, 0.76 ,35,71,34,140, 0.70 ,55,61,73,189, 0.95 ,73,57,25,155, 0.78 ,75,67,38,180, 0.90 ,40,48,30,118, 0.59 ,934, 0.78 ,kinesthetic,4,Study more
ST-165,70,79,149, 0.75 ,25,73,67,165, 0.83 ,36,66,28,130, 0.65 ,60,32,20,112, 0.56 ,32,41,26,99, 0.50 ,66,59,32,157, 0.79 ,812, 0.68 ,kinesthetic,2,Ask questions
ST-166,20,33,53, 0.27 ,20,33,63,116, 0.58 ,20,48,32,100, 0.50 ,24,22,32,78, 0.39 ,76,78,27,181, 0.91 ,35,62,25,122, 0.61 ,650, 0.54 ,kinesthetic,4,Join study group
ST-167,56,42,98, 0.49 ,33,45,24,102, 0.51 ,58,61,39,158, 0.79 ,74,52,39,165, 0.83 ,31,61,30,122, 0.61 ,44,40,30,114, 0.57 ,759, 0.63 ,visual,4,Study more
ST-168,34,94,128, 0.64 ,21,63,55,139, 0.70 ,57,56,25,138, 0.69 ,30,58,20,108, 0.54 ,55,22,23,100, 0.50 ,44,43,21,108, 0.54 ,721, 0.60 ,kinesthetic,2,Study more
ST-169,99,58,157, 0.79 ,30,67,48,145, 0.73 ,49,63,66,178, 0.89 ,75,47,21,143, 0.72 ,52,49,20,121, 0.61 ,76,44,26,146, 0.73 ,890, 0.74 ,auditory,2,Ask questions
ST-170,35,57,92, 0.46 ,22,42,47,111, 0.56 ,57,73,72,202, 1.01 ,27,63,39,129, 0.65 ,29,26,27,82, 0.41 ,38,47,31,116, 0.58 ,732, 0.61 ,visual,3,Join study group
ST-171,27,48,75, 0.38 ,42,66,46,154, 0.77 ,58,59,42,159, 0.80 ,61,49,36,146, 0.73 ,33,52,31,116, 0.58 ,48,66,23,137, 0.69 ,787, 0.66 ,kinesthetic,1,Ask questions
ST-172,59,50,109, 0.55 ,20,71,44,135, 0.68 ,27,35,40,102, 0.51 ,36,41,26,103, 0.52 ,29,71,31,131, 0.66 ,29,67,22,118, 0.59 ,698, 0.58 ,kinesthetic,1,Practice regularly
ST-173,54,31,85, 0.43 ,52,73,28,153, 0.77 ,46,47,78,171, 0.86 ,46,33,33,112, 0.56 ,66,71,37,174, 0.87 ,61,39,37,137, 0.69 ,832, 0.69 ,auditory,4,Ask questions
ST-174,77,78,155, 0.78 ,42,35,48,125, 0.63 ,27,45,49,121, 0.61 ,71,72,34,177, 0.89 ,42,37,29,108, 0.54 ,62,20,28,110, 0.55 ,796, 0.66 ,visual,1,Study more
ST-175,52,75,127, 0.64 ,34,43,75,152, 0.76 ,51,50,43,144, 0.72 ,23,42,24,89, 0.45 ,28,65,21,114, 0.57 ,57,20,20,97, 0.49 ,723, 0.60 ,visual,1,Study more
ST-176,28,36,64, 0.32 ,36,52,50,138, 0.69 ,27,52,53,132, 0.66 ,32,66,26,124, 0.62 ,45,51,24,120, 0.60 ,67,21,35,123, 0.62 ,701, 0.58 ,auditory,4,Practice regularly
ST-177,58,67,125, 0.63 ,31,57,41,129, 0.65 ,23,33,72,128, 0.64 ,45,45,36,126, 0.63 ,79,54,33,166, 0.83 ,50,52,25,127, 0.64 ,801, 0.67 ,visual,4,Practice regularly
ST-178,55,20,75, 0.38 ,21,40,71,132, 0.66 ,29,43,57,129, 0.65 ,28,78,34,140, 0.70 ,62,47,22,131, 0.66 ,61,29,30,120, 0.60 ,727, 0.61 ,kinesthetic,1,Ask questions
ST-179,73,83,156, 0.78 ,29,29,70,128, 0.64 ,53,55,44,152, 0.76 ,29,21,25,75, 0.38 ,37,71,33,141, 0.71 ,61,45,24,130, 0.65 ,782, 0.65 ,visual,3,Ask questions
ST-180,23,21,44, 0.22 ,53,65,36,154, 0.77 ,46,74,46,166, 0.83 ,72,45,29,146, 0.73 ,78,67,28,173, 0.87 ,42,28,36,106, 0.53 ,789, 0.66 ,kinesthetic,4,Study more
ST-181,93,89,182, 0.91 ,23,68,33,124, 0.62 ,45,68,45,158, 0.79 ,46,28,24,98, 0.49 ,36,71,39,146, 0.73 ,50,44,23,117, 0.59 ,825, 0.69 ,visual,4,Ask questions
ST-182,52,98,150, 0.75 ,42,64,79,185, 0.93 ,33,71,33,137, 0.69 ,63,65,34,162, 0.81 ,50,65,34,149, 0.75 ,35,78,30,143, 0.72 ,926, 0.77 ,auditory,1,Join study group
ST-183,68,27,95, 0.48 ,20,67,30,117, 0.59 ,40,21,77,138, 0.69 ,47,24,35,106, 0.53 ,65,35,25,125, 0.63 ,79,75,21,175, 0.88 ,756, 0.63 ,auditory,4,Ask questions
ST-184,67,72,139, 0.70 ,54,78,52,184, 0.92 ,58,40,79,177, 0.89 ,70,20,30,120, 0.60 ,64,55,35,154, 0.77 ,77,30,35,142, 0.71 ,916, 0.76 ,auditory,3,Study more
ST-185,80,40,120, 0.60 ,54,26,53,133, 0.67 ,59,22,40,121, 0.61 ,45,79,28,152, 0.76 ,59,44,36,139, 0.70 ,34,58,31,123, 0.62 ,788, 0.66 ,visual,1,Join study group
ST-186,74,65,139, 0.70 ,50,29,79,158, 0.79 ,35,44,60,139, 0.70 ,43,72,36,151, 0.76 ,51,22,27,100, 0.50 ,49,28,23,100, 0.50 ,787, 0.66 ,visual,5,Study more
ST-187,57,66,123, 0.62 ,48,79,42,169, 0.85 ,48,42,46,136, 0.68 ,57,53,20,130, 0.65 ,53,76,28,157, 0.79 ,31,36,36,103, 0.52 ,818, 0.68 ,kinesthetic,1,Join study group
ST-188,96,63,159, 0.80 ,25,54,50,129, 0.65 ,22,28,36,86, 0.43 ,71,52,31,154, 0.77 ,37,24,28,89, 0.45 ,34,70,20,124, 0.62 ,741, 0.62 ,kinesthetic,5,Practice regularly
ST-189,22,67,89, 0.45 ,41,64,24,129, 0.65 ,48,79,50,177, 0.89 ,63,77,26,166, 0.83 ,28,77,24,129, 0.65 ,39,28,32,99, 0.50 ,789, 0.66 ,auditory,2,Study more
ST-190,20,71,91, 0.46 ,39,22,57,118, 0.59 ,58,73,45,176, 0.88 ,79,36,27,142, 0.71 ,22,26,21,69, 0.35 ,49,62,28,139, 0.70 ,735, 0.61 ,auditory,1,Ask questions
ST-191,31,85,116, 0.58 ,59,63,32,154, 0.77 ,21,30,50,101, 0.51 ,50,33,33,116, 0.58 ,33,57,31,121, 0.61 ,65,60,35,160, 0.80 ,768, 0.64 ,kinesthetic,5,Join study group
ST-192,71,56,127, 0.64 ,20,63,36,119, 0.60 ,37,63,53,153, 0.77 ,47,30,31,108, 0.54 ,70,45,22,137, 0.69 ,31,46,27,104, 0.52 ,748, 0.62 ,kinesthetic,3,Ask questions
ST-193,37,24,61, 0.31 ,23,64,75,162, 0.81 ,56,38,46,140, 0.70 ,67,25,24,116, 0.58 ,68,38,33,139, 0.70 ,66,40,24,130, 0.65 ,748, 0.62 ,kinesthetic,5,Join study group
ST-194,67,24,91, 0.46 ,26,25,63,114, 0.57 ,39,65,67,171, 0.86 ,25,67,31,123, 0.62 ,24,30,31,85, 0.43 ,47,22,20,89, 0.45 ,673, 0.56 ,kinesthetic,1,Study more
ST-195,61,88,149, 0.75 ,20,23,75,118, 0.59 ,20,50,75,145, 0.73 ,78,49,26,153, 0.77 ,31,71,31,133, 0.67 ,36,32,22,90, 0.45 ,788, 0.66 ,auditory,3,Ask questions
ST-196,62,24,86, 0.43 ,52,79,74,205, 1.03 ,32,74,54,160, 0.80 ,53,32,27,112, 0.56 ,54,54,36,144, 0.72 ,68,35,31,134, 0.67 ,841, 0.70 ,auditory,1,Ask questions
ST-197,38,93,131, 0.66 ,54,21,78,153, 0.77 ,34,30,66,130, 0.65 ,68,64,26,158, 0.79 ,37,48,37,122, 0.61 ,73,33,29,135, 0.68 ,829, 0.69 ,auditory,3,Practice regularly
ST-198,67,50,117, 0.59 ,58,41,64,163, 0.82 ,45,55,78,178, 0.89 ,32,37,35,104, 0.52 ,62,57,23,142, 0.71 ,25,47,38,110, 0.55 ,814, 0.68 ,visual,4,Ask questions
ST-199,32,31,63, 0.32 ,33,60,46,139, 0.70 ,43,48,65,156, 0.78 ,64,49,26,139, 0.70 ,70,76,25,171, 0.86 ,20,61,23,104, 0.52 ,772, 0.64 ,auditory,5,Ask questions
ST-200,96,92,188, 0.94 ,27,47,68,142, 0.71 ,58,51,72,181, 0.91 ,70,43,25,138, 0.69 ,67,46,29,142, 0.71 ,53,73,20,146, 0.73 ,937, 0.78 ,kinesthetic,1,Practice regularly
ST-201,50,84,134, 0.67 ,50,29,43,122, 0.61 ,36,58,37,131, 0.66 ,61,75,26,162, 0.81 ,71,49,34,154, 0.77 ,21,53,32,106, 0.53 ,809, 0.67 ,auditory,3,Study more
ST-202,41,20,61, 0.31 ,52,24,58,134, 0.67 ,51,35,59,145, 0.73 ,31,39,32,102, 0.51 ,44,70,33,147, 0.74 ,52,78,35,165, 0.83 ,754, 0.63 ,visual,5,Ask questions
ST-203,89,32,121, 0.61 ,52,43,40,135, 0.68 ,33,77,30,140, 0.70 ,43,72,25,140, 0.70 ,60,28,20,108, 0.54 ,40,58,21,119, 0.60 ,763, 0.64 ,visual,4,Join study group
ST-204,72,62,134, 0.67 ,29,77,36,142, 0.71 ,54,38,43,135, 0.68 ,55,41,21,117, 0.59 ,39,43,31,113, 0.57 ,23,50,31,104, 0.52 ,745, 0.62 ,kinesthetic,4,Study more
ST-205,34,92,126, 0.63 ,41,35,57,133, 0.67 ,44,45,59,148, 0.74 ,65,46,37,148, 0.74 ,26,74,30,130, 0.65 ,37,63,22,122, 0.61 ,807, 0.67 ,visual,5,Study more
ST-206,79,27,106, 0.53 ,37,28,55,120, 0.60 ,53,70,65,188, 0.94 ,35,75,34,144, 0.72 ,62,35,29,126, 0.63 ,70,77,37,184, 0.92 ,868, 0.72 ,kinesthetic,1,Join study group
ST-207,96,89,185, 0.93 ,41,29,34,104, 0.52 ,56,61,73,190, 0.95 ,56,25,31,112, 0.56 ,26,59,29,114, 0.57 ,70,76,20,166, 0.83 ,871, 0.73 ,visual,3,Ask questions
ST-208,68,94,162, 0.81 ,33,72,65,170, 0.85 ,57,50,36,143, 0.72 ,62,51,38,151, 0.76 ,23,56,22,101, 0.51 ,53,33,38,124, 0.62 ,851, 0.71 ,visual,2,Practice regularly
ST-209,75,78,153, 0.77 ,48,60,62,170, 0.85 ,26,56,26,108, 0.54 ,49,27,36,112, 0.56 ,31,49,22,102, 0.51 ,27,27,39,93, 0.47 ,738, 0.62 ,auditory,1,Practice regularly
ST-210,66,44,110, 0.55 ,27,21,62,110, 0.55 ,48,74,22,144, 0.72 ,70,28,27,125, 0.63 ,33,37,25,95, 0.48 ,70,23,21,114, 0.57 ,698, 0.58 ,kinesthetic,5,Study more
ST-211,20,23,43, 0.22 ,46,54,36,136, 0.68 ,56,78,34,168, 0.84 ,59,45,32,136, 0.68 ,42,52,37,131, 0.66 ,45,61,22,128, 0.64 ,742, 0.62 ,auditory,2,Ask questions
ST-212,80,22,102, 0.51 ,28,70,79,177, 0.89 ,38,53,64,155, 0.78 ,37,71,35,143, 0.72 ,25,74,38,137, 0.69 ,74,59,29,162, 0.81 ,876, 0.73 ,kinesthetic,4,Ask questions
ST-213,92,45,137, 0.69 ,22,46,65,133, 0.67 ,40,42,20,102, 0.51 ,41,36,33,110, 0.55 ,37,21,33,91, 0.46 ,20,23,38,81, 0.41 ,654, 0.55 ,kinesthetic,1,Practice regularly
ST-214,40,50,90, 0.45 ,33,67,53,153, 0.77 ,45,57,51,153, 0.77 ,62,45,26,133, 0.67 ,26,68,38,132, 0.66 ,40,48,31,119, 0.60 ,780, 0.65 ,auditory,5,Join study group
ST-215,82,21,103, 0.52 ,31,66,47,144, 0.72 ,34,62,79,175, 0.88 ,29,55,37,121, 0.61 ,66,20,26,112, 0.56 ,35,48,31,114, 0.57 ,769, 0.64 ,kinesthetic,3,Practice regularly
ST-216,69,20,89, 0.45 ,27,34,41,102, 0.51 ,39,37,52,128, 0.64 ,65,29,23,117, 0.59 ,51,23,36,110, 0.55 ,67,46,29,142, 0.71 ,688, 0.57 ,visual,5,Study more
ST-217,58,73,131, 0.66 ,37,47,58,142, 0.71 ,39,50,34,123, 0.62 ,76,48,38,162, 0.81 ,39,26,30,95, 0.48 ,68,57,25,150, 0.75 ,803, 0.67 ,kinesthetic,3,Ask questions
ST-218,88,42,130, 0.65 ,56,22,30,108, 0.54 ,29,61,68,158, 0.79 ,22,57,30,109, 0.55 ,64,22,27,113, 0.57 ,73,46,32,151, 0.76 ,769, 0.64 ,visual,1,Join study group
ST-219,99,70,169, 0.85 ,59,66,38,163, 0.82 ,20,42,69,131, 0.66 ,27,78,34,139, 0.70 ,76,57,39,172, 0.86 ,50,47,22,119, 0.60 ,893, 0.74 ,kinesthetic,4,Ask questions
ST-220,96,81,177, 0.89 ,38,64,69,171, 0.86 ,54,49,31,134, 0.67 ,42,27,26,95, 0.48 ,53,27,20,100, 0.50 ,31,33,39,103, 0.52 ,780, 0.65 ,visual,4,Study more
ST-221,95,56,151, 0.76 ,55,28,28,111, 0.56 ,25,59,37,121, 0.61 ,76,64,37,177, 0.89 ,21,52,37,110, 0.55 ,60,23,30,113, 0.57 ,783, 0.65 ,visual,3,Study more
ST-222,37,43,80, 0.40 ,56,78,52,186, 0.93 ,37,31,70,138, 0.69 ,42,64,30,136, 0.68 ,78,35,25,138, 0.69 ,20,65,34,119, 0.60 ,797, 0.66 ,auditory,4,Practice regularly
ST-223,62,46,108, 0.54 ,32,32,60,124, 0.62 ,20,50,23,93, 0.47 ,47,38,36,121, 0.61 ,70,70,28,168, 0.84 ,55,23,35,113, 0.57 ,727, 0.61 ,auditory,1,Study more
ST-224,86,42,128, 0.64 ,43,37,22,102, 0.51 ,56,62,57,175, 0.88 ,78,47,30,155, 0.78 ,72,45,38,155, 0.78 ,49,58,20,127, 0.64 ,842, 0.70 ,kinesthetic,4,Study more
ST-225,95,34,129, 0.65 ,55,52,22,129, 0.65 ,58,23,67,148, 0.74 ,29,78,21,128, 0.64 ,71,52,26,149, 0.75 ,76,36,23,135, 0.68 ,818, 0.68 ,kinesthetic,4,Join study group
ST-226,44,77,121, 0.61 ,32,63,79,174, 0.87 ,30,76,56,162, 0.81 ,41,25,28,94, 0.47 ,22,43,34,99, 0.50 ,77,73,37,187, 0.94 ,837, 0.70 ,kinesthetic,2,Study more
ST-227,60,94,154, 0.77 ,41,32,77,150, 0.75 ,46,45,24,115, 0.58 ,55,20,31,106, 0.53 ,51,48,28,127, 0.64 ,45,49,35,129, 0.65 ,781, 0.65 ,kinesthetic,1,Practice regularly
ST-228,64,86,150, 0.75 ,45,49,74,168, 0.84 ,48,28,24,100, 0.50 ,76,73,33,182, 0.91 ,66,46,22,134, 0.67 ,29,32,38,99, 0.50 ,833, 0.69 ,auditory,4,Practice regularly
ST-229,79,20,99, 0.50 ,40,63,22,125, 0.63 ,31,78,33,142, 0.71 ,60,24,37,121, 0.61 ,27,77,38,142, 0.71 ,25,58,38,121, 0.61 ,750, 0.63 ,kinesthetic,1,Ask questions
ST-230,57,73,130, 0.65 ,51,48,72,171, 0.86 ,37,33,55,125, 0.63 ,35,78,20,133, 0.67 ,61,40,28,129, 0.65 ,48,66,37,151, 0.76 ,839, 0.70 ,kinesthetic,1,Join study group
ST-231,54,66,120, 0.60 ,41,69,42,152, 0.76 ,25,30,50,105, 0.53 ,49,73,37,159, 0.80 ,46,55,30,131, 0.66 ,28,33,34,95, 0.48 ,762, 0.64 ,visual,4,Study more
ST-232,33,44,77, 0.39 ,39,36,40,115, 0.58 ,28,58,48,134, 0.67 ,49,38,27,114, 0.57 ,30,47,24,101, 0.51 ,32,54,33,119, 0.60 ,660, 0.55 ,auditory,5,Join study group
ST-233,71,59,130, 0.65 ,51,43,47,141, 0.71 ,30,33,29,92, 0.46 ,65,53,26,144, 0.72 ,62,55,35,152, 0.76 ,60,41,23,124, 0.62 ,783, 0.65 ,auditory,3,Ask questions
ST-234,35,93,128, 0.64 ,43,59,51,153, 0.77 ,52,78,51,181, 0.91 ,63,38,30,131, 0.66 ,23,74,36,133, 0.67 ,39,70,38,147, 0.74 ,873, 0.73 ,visual,2,Ask questions
ST-235,24,52,76, 0.38 ,26,74,59,159, 0.80 ,28,62,26,116, 0.58 ,23,58,22,103, 0.52 ,45,27,33,105, 0.53 ,65,22,35,122, 0.61 ,681, 0.57 ,auditory,2,Practice regularly
ST-236,66,68,134, 0.67 ,57,26,70,153, 0.77 ,20,76,28,124, 0.62 ,56,70,28,154, 0.77 ,78,48,21,147, 0.74 ,66,20,22,108, 0.54 ,820, 0.68 ,auditory,2,Practice regularly
ST-237,46,79,125, 0.63 ,37,65,60,162, 0.81 ,56,29,39,124, 0.62 ,30,48,33,111, 0.56 ,42,79,30,151, 0.76 ,28,30,32,90, 0.45 ,763, 0.64 ,visual,1,Join study group
ST-238,93,52,145, 0.73 ,33,54,56,143, 0.72 ,29,24,70,123, 0.62 ,63,72,23,158, 0.79 ,73,22,22,117, 0.59 ,58,77,37,172, 0.86 ,858, 0.72 ,kinesthetic,2,Ask questions
ST-239,51,35,86, 0.43 ,56,21,27,104, 0.52 ,40,34,51,125, 0.63 ,79,54,21,154, 0.77 ,38,49,28,115, 0.58 ,35,50,31,116, 0.58 ,700, 0.58 ,auditory,5,Study more
ST-240,88,46,134, 0.67 ,40,23,59,122, 0.61 ,30,70,24,124, 0.62 ,26,38,34,98, 0.49 ,33,31,27,91, 0.46 ,65,34,33,132, 0.66 ,701, 0.58 ,kinesthetic,3,Study more
ST-241,56,23,79, 0.40 ,26,52,70,148, 0.74 ,36,70,29,135, 0.68 ,43,36,31,110, 0.55 ,34,50,29,113, 0.57 ,53,24,32,109, 0.55 ,694, 0.58 ,auditory,2,Study more
ST-242,86,46,132, 0.66 ,29,35,26,90, 0.45 ,35,26,27,88, 0.44 ,31,56,36,123, 0.62 ,31,39,31,101, 0.51 ,46,27,36,109, 0.55 ,643, 0.54 ,auditory,3,Join study group
ST-243,74,65,139, 0.70 ,49,64,35,148, 0.74 ,47,27,58,132, 0.66 ,20,71,32,123, 0.62 ,69,25,39,133, 0.67 ,67,72,34,173, 0.87 ,848, 0.71 ,auditory,2,Join study group
ST-244,88,68,156, 0.78 ,21,67,23,111, 0.56 ,26,31,78,135, 0.68 ,39,48,35,122, 0.61 ,57,40,23,120, 0.60 ,23,54,31,108, 0.54 ,752, 0.63 ,visual,2,Join study group
ST-245,40,75,115, 0.58 ,24,55,44,123, 0.62 ,57,40,69,166, 0.83 ,27,78,28,133, 0.67 ,27,24,39,90, 0.45 ,58,55,21,134, 0.67 ,761, 0.63 ,visual,5,Join study group
ST-246,64,67,131, 0.66 ,59,46,72,177, 0.89 ,21,46,65,132, 0.66 ,67,20,24,111, 0.56 ,56,60,27,143, 0.72 ,33,46,21,100, 0.50 ,794, 0.66 ,visual,2,Join study group
ST-247,72,86,158, 0.79 ,38,52,75,165, 0.83 ,56,60,49,165, 0.83 ,51,63,32,146, 0.73 ,28,35,37,100, 0.50 ,41,23,22,86, 0.43 ,820, 0.68 ,auditory,4,Ask questions
ST-248,91,46,137, 0.69 ,35,31,26,92, 0.46 ,49,71,71,191, 0.96 ,23,78,25,126, 0.63 ,36,71,38,145, 0.73 ,79,28,33,140, 0.70 ,831, 0.69 ,auditory,1,Practice regularly
ST-249,49,39,88, 0.44 ,48,63,58,169, 0.85 ,35,46,45,126, 0.63 ,50,36,29,115, 0.58 ,47,45,26,118, 0.59 ,28,66,32,126, 0.63 ,742, 0.62 ,auditory,1,Join study group
ST-250,82,55,137, 0.69 ,50,57,51,158, 0.79 ,53,22,47,122, 0.61 ,22,29,28,79, 0.40 ,71,59,21,151, 0.76 ,50,57,24,131, 0.66 ,778, 0.65 ,auditory,3,Join study group
ST-251,69,56,125, 0.63 ,53,36,61,150, 0.75 ,50,38,71,159, 0.80 ,65,51,36,152, 0.76 ,49,20,33,102, 0.51 ,32,60,28,120, 0.60 ,808, 0.67 ,kinesthetic,5,Join study group
ST-252,28,34,62, 0.31 ,46,26,24,96, 0.48 ,58,37,63,158, 0.79 ,50,59,39,148, 0.74 ,42,74,29,145, 0.73 ,50,73,30,153, 0.77 ,762, 0.64 ,kinesthetic,3,Join study group
ST-253,39,59,98, 0.49 ,35,49,32,116, 0.58 ,39,34,72,145, 0.73 ,64,28,39,131, 0.66 ,25,24,36,85, 0.43 ,51,74,25,150, 0.75 ,725, 0.60 ,auditory,5,Practice regularly
ST-254,66,91,157, 0.79 ,47,22,75,144, 0.72 ,28,55,77,160, 0.80 ,78,63,29,170, 0.85 ,29,37,20,86, 0.43 ,32,51,27,110, 0.55 ,827, 0.69 ,visual,1,Ask questions
ST-255,48,57,105, 0.53 ,47,69,21,137, 0.69 ,41,64,72,177, 0.89 ,43,55,26,124, 0.62 ,58,32,22,112, 0.56 ,53,49,37,139, 0.70 ,794, 0.66 ,visual,1,Join study group
ST-256,77,94,171, 0.86 ,27,38,28,93, 0.47 ,48,69,40,157, 0.79 ,39,54,26,119, 0.60 ,52,44,35,131, 0.66 ,77,51,24,152, 0.76 ,823, 0.69 ,visual,3,Ask questions
ST-257,35,47,82, 0.41 ,37,66,63,166, 0.83 ,40,20,50,110, 0.55 ,47,72,38,157, 0.79 ,30,51,37,118, 0.59 ,44,74,20,138, 0.69 ,771, 0.64 ,kinesthetic,2,Study more
ST-258,85,50,135, 0.68 ,33,51,25,109, 0.55 ,24,61,43,128, 0.64 ,58,74,33,165, 0.83 ,61,63,24,148, 0.74 ,74,54,33,161, 0.81 ,846, 0.71 ,auditory,5,Practice regularly
ST-259,52,61,113, 0.57 ,36,58,59,153, 0.77 ,21,67,48,136, 0.68 ,65,59,33,157, 0.79 ,24,41,35,100, 0.50 ,70,56,20,146, 0.73 ,805, 0.67 ,kinesthetic,2,Ask questions
ST-260,35,55,90, 0.45 ,21,77,70,168, 0.84 ,49,53,54,156, 0.78 ,45,52,39,136, 0.68 ,24,69,24,117, 0.59 ,67,62,23,152, 0.76 ,819, 0.68 ,visual,4,Study more
ST-261,74,98,172, 0.86 ,26,47,41,114, 0.57 ,24,36,71,131, 0.66 ,76,60,23,159, 0.80 ,28,69,38,135, 0.68 ,26,29,33,88, 0.44 ,799, 0.67 ,auditory,5,Join study group
ST-262,91,96,187, 0.94 ,21,64,46,131, 0.66 ,29,68,67,164, 0.82 ,57,62,24,143, 0.72 ,26,67,23,116, 0.58 ,22,75,25,122, 0.61 ,863, 0.72 ,kinesthetic,1,Study more
ST-263,56,58,114, 0.57 ,32,75,25,132, 0.66 ,39,22,22,83, 0.42 ,40,64,33,137, 0.69 ,75,56,27,158, 0.79 ,71,40,32,143, 0.72 ,767, 0.64 ,kinesthetic,1,Practice regularly
ST-264,30,20,50, 0.25 ,55,71,75,201, 1.01 ,26,78,74,178, 0.89 ,29,35,34,98, 0.49 ,37,45,31,113, 0.57 ,51,24,29,104, 0.52 ,744, 0.62 ,visual,5,Study more
ST-265,29,82,111, 0.56 ,45,75,54,174, 0.87 ,49,79,22,150, 0.75 ,39,28,38,105, 0.53 ,21,61,32,114, 0.57 ,68,20,22,110, 0.55 ,764, 0.64 ,visual,4,Ask questions
ST-266,26,67,93, 0.47 ,32,27,35,94, 0.47 ,32,43,24,99, 0.50 ,74,21,26,121, 0.61 ,29,31,38,98, 0.49 ,23,37,33,93, 0.47 ,598, 0.50 ,auditory,3,Study more
ST-267,80,21,101, 0.51 ,31,52,79,162, 0.81 ,20,74,48,142, 0.71 ,40,58,33,131, 0.66 ,50,62,22,134, 0.67 ,66,40,27,133, 0.67 ,803, 0.67 ,kinesthetic,4,Practice regularly
ST-268,54,53,107, 0.54 ,25,23,63,111, 0.56 ,43,57,44,144, 0.72 ,27,61,30,118, 0.59 ,51,32,24,107, 0.54 ,75,31,39,145, 0.73 ,732, 0.61 ,kinesthetic,2,Ask questions
ST-269,94,44,138, 0.69 ,54,31,47,132, 0.66 ,32,44,36,112, 0.56 ,42,69,30,141, 0.71 ,61,58,20,139, 0.70 ,22,77,39,138, 0.69 ,800, 0.67 ,kinesthetic,2,Practice regularly
ST-270,87,94,181, 0.91 ,22,23,72,117, 0.59 ,54,55,42,151, 0.76 ,44,20,32,96, 0.48 ,24,39,33,96, 0.48 ,63,28,23,114, 0.57 ,755, 0.63 ,visual,1,Join study group
ST-271,33,23,56, 0.28 ,27,30,57,114, 0.57 ,47,63,75,185, 0.93 ,29,67,29,125, 0.63 ,57,66,39,162, 0.81 ,65,72,27,164, 0.82 ,806, 0.67 ,visual,1,Study more
ST-272,40,47,87, 0.44 ,45,26,78,149, 0.75 ,36,53,59,148, 0.74 ,33,73,20,126, 0.63 ,27,49,36,112, 0.56 ,23,79,36,138, 0.69 ,760, 0.63 ,auditory,1,Practice regularly
ST-273,77,85,162, 0.81 ,41,21,46,108, 0.54 ,49,62,52,163, 0.82 ,66,55,29,150, 0.75 ,35,37,35,107, 0.54 ,31,66,35,132, 0.66 ,822, 0.69 ,visual,2,Practice regularly
ST-274,45,88,133, 0.67 ,40,72,46,158, 0.79 ,55,23,60,138, 0.69 ,54,57,27,138, 0.69 ,53,44,36,133, 0.67 ,58,61,34,153, 0.77 ,853, 0.71 ,visual,3,Study more
ST-275,61,67,128, 0.64 ,25,23,56,104, 0.52 ,56,76,73,205, 1.03 ,70,30,36,136, 0.68 ,51,57,31,139, 0.70 ,73,25,34,132, 0.66 ,844, 0.70 ,kinesthetic,2,Study more
ST-276,85,51,136, 0.68 ,29,20,68,117, 0.59 ,50,53,66,169, 0.85 ,49,45,31,125, 0.63 ,56,38,21,115, 0.58 ,72,78,38,188, 0.94 ,850, 0.71 ,auditory,3,Study more
ST-277,32,81,113, 0.57 ,46,28,73,147, 0.74 ,44,73,78,195, 0.98 ,52,45,23,120, 0.60 ,23,62,27,112, 0.56 ,73,20,30,123, 0.62 ,810, 0.68 ,kinesthetic,4,Practice regularly
ST-278,37,33,70, 0.35 ,29,31,78,138, 0.69 ,41,53,40,134, 0.67 ,28,40,38,106, 0.53 ,63,43,31,137, 0.69 ,29,58,36,123, 0.62 ,708, 0.59 ,visual,3,Ask questions
ST-279,66,95,161, 0.81 ,40,78,36,154, 0.77 ,30,34,26,90, 0.45 ,25,22,26,73, 0.37 ,25,20,25,70, 0.35 ,45,44,36,125, 0.63 ,673, 0.56 ,visual,1,Study more
ST-280,66,40,106, 0.53 ,42,47,37,126, 0.63 ,59,67,69,195, 0.98 ,39,53,29,121, 0.61 ,58,51,39,148, 0.74 ,57,63,38,158, 0.79 ,854, 0.71 ,kinesthetic,4,Practice regularly
ST-281,55,46,101, 0.51 ,42,68,57,167, 0.84 ,56,53,39,148, 0.74 ,31,21,31,83, 0.42 ,62,75,36,173, 0.87 ,76,65,30,171, 0.86 ,843, 0.70 ,kinesthetic,1,Study more
ST-282,38,76,114, 0.57 ,52,62,30,144, 0.72 ,56,47,61,164, 0.82 ,57,29,27,113, 0.57 ,22,79,32,133, 0.67 ,54,38,39,131, 0.66 ,799, 0.67 ,kinesthetic,3,Ask questions
ST-283,56,95,151, 0.76 ,51,67,75,193, 0.97 ,53,22,60,135, 0.68 ,79,64,25,168, 0.84 ,34,34,27,95, 0.48 ,43,40,22,105, 0.53 ,847, 0.71 ,visual,2,Ask questions
ST-284,94,61,155, 0.78 ,47,29,69,145, 0.73 ,38,73,20,131, 0.66 ,47,23,22,92, 0.46 ,53,41,20,114, 0.57 ,61,26,23,110, 0.55 ,747, 0.62 ,visual,2,Ask questions
ST-285,30,83,113, 0.57 ,25,75,50,150, 0.75 ,59,75,76,210, 1.05 ,28,32,26,86, 0.43 ,38,66,33,137, 0.69 ,33,39,27,99, 0.50 ,795, 0.66 ,auditory,4,Ask questions
ST-286,82,63,145, 0.73 ,39,79,66,184, 0.92 ,47,34,34,115, 0.58 ,62,61,23,146, 0.73 ,22,37,21,80, 0.40 ,20,60,27,107, 0.54 ,777, 0.65 ,kinesthetic,2,Ask questions
ST-287,96,56,152, 0.76 ,40,78,75,193, 0.97 ,37,76,59,172, 0.86 ,42,35,24,101, 0.51 ,21,37,39,97, 0.49 ,48,33,36,117, 0.59 ,832, 0.69 ,visual,3,Ask questions
ST-288,76,28,104, 0.52 ,50,48,64,162, 0.81 ,33,36,78,147, 0.74 ,68,70,31,169, 0.85 ,25,54,38,117, 0.59 ,45,28,38,111, 0.56 ,810, 0.68 ,visual,2,Study more
ST-289,52,96,148, 0.74 ,26,73,61,160, 0.80 ,39,78,46,163, 0.82 ,46,74,29,149, 0.75 ,69,51,31,151, 0.76 ,23,30,25,78, 0.39 ,849, 0.71 ,auditory,3,Practice regularly
ST-290,85,75,160, 0.80 ,47,53,63,163, 0.82 ,59,79,25,163, 0.82 ,36,65,28,129, 0.65 ,23,60,34,117, 0.59 ,58,56,39,153, 0.77 ,885, 0.74 ,kinesthetic,4,Study more
ST-291,87,23,110, 0.55 ,49,60,52,161, 0.81 ,25,71,46,142, 0.71 ,50,41,35,126, 0.63 ,26,77,21,124, 0.62 ,57,47,29,133, 0.67 ,796, 0.66 ,kinesthetic,1,Ask questions
ST-292,70,30,100, 0.50 ,54,40,41,135, 0.68 ,44,70,78,192, 0.96 ,67,55,28,150, 0.75 ,59,35,33,127, 0.64 ,56,74,30,160, 0.80 ,864, 0.72 ,visual,5,Study more
ST-293,71,38,109, 0.55 ,51,56,20,127, 0.64 ,21,53,23,97, 0.49 ,59,36,30,125, 0.63 ,42,30,24,96, 0.48 ,53,27,35,115, 0.58 ,669, 0.56 ,auditory,3,Practice regularly
ST-294,82,32,114, 0.57 ,32,40,24,96, 0.48 ,50,60,43,153, 0.77 ,68,37,24,129, 0.65 ,49,24,38,111, 0.56 ,30,23,27,80, 0.40 ,683, 0.57 ,kinesthetic,5,Practice regularly
ST-295,22,65,87, 0.44 ,59,69,58,186, 0.93 ,23,72,63,158, 0.79 ,57,29,20,106, 0.53 ,62,55,26,143, 0.72 ,42,34,21,97, 0.49 ,777, 0.65 ,kinesthetic,3,Practice regularly
ST-296,93,39,132, 0.66 ,54,74,43,171, 0.86 ,31,20,65,116, 0.58 ,54,71,37,162, 0.81 ,23,32,34,89, 0.45 ,65,56,27,148, 0.74 ,818, 0.68 ,kinesthetic,4,Practice regularly
ST-297,34,41,75, 0.38 ,45,26,46,117, 0.59 ,33,41,61,135, 0.68 ,38,74,21,133, 0.67 ,68,59,23,150, 0.75 ,30,23,30,83, 0.42 ,693, 0.58 ,kinesthetic,5,Practice regularly
ST-298,63,82,145, 0.73 ,20,54,30,104, 0.52 ,35,65,22,122, 0.61 ,67,57,26,150, 0.75 ,46,44,20,110, 0.55 ,51,43,31,125, 0.63 ,756, 0.63 ,auditory,4,Join study group
ST-299,66,25,91, 0.46 ,23,49,21,93, 0.47 ,33,30,46,109, 0.55 ,40,24,39,103, 0.52 ,24,45,23,92, 0.46 ,79,66,28,173, 0.87 ,661, 0.55 ,auditory,1,Join study group
ST-300,34,83,117, 0.59 ,27,47,41,115, 0.58 ,38,55,35,128, 0.64 ,36,30,20,86, 0.43 ,56,28,28,112, 0.56 ,26,20,22,68, 0.34 ,626, 0.52 ,auditory,2,Practice regularly
ST-301,78,70,148, 0.74 ,26,56,33,115, 0.58 ,28,23,26,77, 0.39 ,37,78,38,153, 0.77 ,38,33,39,110, 0.55 ,30,70,29,129, 0.65 ,732, 0.61 ,auditory,2,Ask questions
ST-302,49,94,143, 0.72 ,47,26,58,131, 0.66 ,43,71,52,166, 0.83 ,50,68,25,143, 0.72 ,50,47,26,123, 0.62 ,31,53,36,120, 0.60 ,826, 0.69 ,auditory,4,Study more
ST-303,38,72,110, 0.55 ,44,35,43,122, 0.61 ,33,79,24,136, 0.68 ,36,34,39,109, 0.55 ,50,76,31,157, 0.79 ,35,25,26,86, 0.43 ,720, 0.60 ,auditory,4,Ask questions
ST-304,94,92,186, 0.93 ,51,56,73,180, 0.90 ,49,57,75,181, 0.91 ,41,50,34,125, 0.63 ,74,47,30,151, 0.76 ,48,45,34,127, 0.64 ,950, 0.79 ,kinesthetic,4,Practice regularly
ST-305,85,66,151, 0.76 ,40,21,20,81, 0.41 ,40,30,74,144, 0.72 ,66,26,29,121, 0.61 ,23,66,29,118, 0.59 ,35,64,39,138, 0.69 ,753, 0.63 ,auditory,4,Ask questions
ST-306,57,87,144, 0.72 ,47,60,61,168, 0.84 ,35,46,67,148, 0.74 ,48,67,27,142, 0.71 ,21,65,24,110, 0.55 ,70,63,39,172, 0.86 ,884, 0.74 ,kinesthetic,1,Join study group
ST-307,33,92,125, 0.63 ,36,23,31,90, 0.45 ,45,60,60,165, 0.83 ,77,22,23,122, 0.61 ,62,58,27,147, 0.74 ,54,64,33,151, 0.76 ,800, 0.67 ,kinesthetic,2,Study more
ST-308,41,88,129, 0.65 ,43,53,28,124, 0.62 ,33,42,38,113, 0.57 ,56,55,33,144, 0.72 ,28,54,20,102, 0.51 ,70,25,23,118, 0.59 ,730, 0.61 ,auditory,3,Ask questions
ST-309,78,43,121, 0.61 ,37,79,32,148, 0.74 ,37,36,23,96, 0.48 ,20,70,29,119, 0.60 ,76,27,26,129, 0.65 ,43,43,25,111, 0.56 ,724, 0.60 ,visual,5,Ask questions
ST-310,57,54,111, 0.56 ,35,68,26,129, 0.65 ,57,31,26,114, 0.57 ,30,20,28,78, 0.39 ,49,41,22,112, 0.56 ,22,35,39,96, 0.48 ,640, 0.53 ,kinesthetic,3,Study more
ST-311,35,20,55, 0.28 ,53,40,51,144, 0.72 ,27,70,46,143, 0.72 ,60,77,30,167, 0.84 ,23,49,33,105, 0.53 ,42,49,23,114, 0.57 ,728, 0.61 ,kinesthetic,5,Practice regularly
ST-312,73,55,128, 0.64 ,59,55,66,180, 0.90 ,48,79,24,151, 0.76 ,20,46,22,88, 0.44 ,69,24,21,114, 0.57 ,47,52,32,131, 0.66 ,792, 0.66 ,kinesthetic,2,Join study group
ST-313,44,65,109, 0.55 ,36,36,45,117, 0.59 ,52,48,56,156, 0.78 ,55,72,24,151, 0.76 ,61,35,36,132, 0.66 ,33,77,37,147, 0.74 ,812, 0.68 ,auditory,4,Ask questions
ST-314,93,33,126, 0.63 ,51,77,73,201, 1.01 ,22,62,55,139, 0.70 ,56,41,20,117, 0.59 ,55,74,30,159, 0.80 ,55,60,34,149, 0.75 ,891, 0.74 ,kinesthetic,4,Join study group
ST-315,99,97,196, 0.98 ,38,32,28,98, 0.49 ,22,62,79,163, 0.82 ,22,42,20,84, 0.42 ,32,79,32,143, 0.72 ,38,25,30,93, 0.47 ,777, 0.65 ,kinesthetic,4,Join study group
ST-316,55,96,151, 0.76 ,24,62,33,119, 0.60 ,59,47,32,138, 0.69 ,69,78,30,177, 0.89 ,34,36,36,106, 0.53 ,21,37,22,80, 0.40 ,771, 0.64 ,auditory,1,Practice regularly
ST-317,67,55,122, 0.61 ,28,21,72,121, 0.61 ,49,76,66,191, 0.96 ,71,51,36,158, 0.79 ,32,46,33,111, 0.56 ,40,78,31,149, 0.75 ,852, 0.71 ,kinesthetic,5,Study more
ST-318,87,24,111, 0.56 ,55,61,72,188, 0.94 ,56,79,31,166, 0.83 ,72,29,29,130, 0.65 ,28,60,29,117, 0.59 ,61,63,22,146, 0.73 ,858, 0.72 ,visual,3,Practice regularly
ST-319,75,82,157, 0.79 ,41,25,25,91, 0.46 ,29,41,78,148, 0.74 ,76,56,24,156, 0.78 ,45,48,32,125, 0.63 ,38,25,28,91, 0.46 ,768, 0.64 ,auditory,3,Study more
ST-320,36,65,101, 0.51 ,20,23,25,68, 0.34 ,33,34,23,90, 0.45 ,78,24,28,130, 0.65 ,78,64,22,164, 0.82 ,37,54,30,121, 0.61 ,674, 0.56 ,visual,2,Study more
ST-321,58,97,155, 0.78 ,52,58,44,154, 0.77 ,41,57,63,161, 0.81 ,47,69,36,152, 0.76 ,46,56,38,140, 0.70 ,65,60,24,149, 0.75 ,911, 0.76 ,kinesthetic,1,Ask questions
ST-322,73,50,123, 0.62 ,27,66,63,156, 0.78 ,45,46,69,160, 0.80 ,25,44,24,93, 0.47 ,28,63,28,119, 0.60 ,68,54,33,155, 0.78 ,806, 0.67 ,auditory,4,Join study group
ST-323,91,22,113, 0.57 ,45,36,61,142, 0.71 ,21,44,31,96, 0.48 ,20,63,29,112, 0.56 ,26,36,30,92, 0.46 ,78,47,26,151, 0.76 ,706, 0.59 ,visual,1,Study more
ST-324,39,99,138, 0.69 ,33,55,70,158, 0.79 ,28,58,66,152, 0.76 ,50,78,25,153, 0.77 ,55,35,35,125, 0.63 ,25,29,27,81, 0.41 ,807, 0.67 ,auditory,2,Study more
ST-325,51,95,146, 0.73 ,47,28,75,150, 0.75 ,28,70,54,152, 0.76 ,29,78,20,127, 0.64 ,58,58,26,142, 0.71 ,64,60,38,162, 0.81 ,879, 0.73 ,kinesthetic,5,Ask questions
ST-326,71,49,120, 0.60 ,51,21,78,150, 0.75 ,44,69,54,167, 0.84 ,66,66,30,162, 0.81 ,61,79,30,170, 0.85 ,76,31,37,144, 0.72 ,913, 0.76 ,auditory,2,Practice regularly
ST-327,64,96,160, 0.80 ,22,42,47,111, 0.56 ,44,38,50,132, 0.66 ,27,65,32,124, 0.62 ,27,69,39,135, 0.68 ,53,22,37,112, 0.56 ,774, 0.65 ,auditory,2,Join study group
ST-328,92,43,135, 0.68 ,46,68,58,172, 0.86 ,20,38,54,112, 0.56 ,58,77,28,163, 0.82 ,64,33,39,136, 0.68 ,73,50,21,144, 0.72 ,862, 0.72 ,visual,3,Practice regularly
ST-329,96,87,183, 0.92 ,58,38,69,165, 0.83 ,47,60,27,134, 0.67 ,37,60,25,122, 0.61 ,78,57,33,168, 0.84 ,32,33,34,99, 0.50 ,871, 0.73 ,visual,1,Practice regularly
ST-330,60,65,125, 0.63 ,32,52,41,125, 0.63 ,59,76,33,168, 0.84 ,36,54,31,121, 0.61 ,39,61,32,132, 0.66 ,58,45,39,142, 0.71 ,813, 0.68 ,kinesthetic,2,Practice regularly
ST-331,35,90,125, 0.63 ,57,39,37,133, 0.67 ,54,47,22,123, 0.62 ,35,65,25,125, 0.63 ,42,67,36,145, 0.73 ,32,48,31,111, 0.56 ,762, 0.64 ,visual,4,Join study group
ST-332,60,59,119, 0.60 ,42,28,78,148, 0.74 ,55,71,62,188, 0.94 ,26,75,20,121, 0.61 ,56,35,24,115, 0.58 ,34,30,26,90, 0.45 ,781, 0.65 ,kinesthetic,1,Ask questions
ST-333,44,69,113, 0.57 ,44,37,58,139, 0.70 ,49,47,45,141, 0.71 ,37,49,30,116, 0.58 ,71,53,27,151, 0.76 ,39,49,33,121, 0.61 ,781, 0.65 ,auditory,4,Practice regularly
ST-334,86,65,151, 0.76 ,21,78,34,133, 0.67 ,29,31,28,88, 0.44 ,76,67,38,181, 0.91 ,70,26,26,122, 0.61 ,34,21,21,76, 0.38 ,751, 0.63 ,auditory,1,Ask questions
ST-335,40,56,96, 0.48 ,58,50,58,166, 0.83 ,46,61,75,182, 0.91 ,58,29,37,124, 0.62 ,66,75,24,165, 0.83 ,39,75,32,146, 0.73 ,879, 0.73 ,kinesthetic,2,Ask questions
ST-336,22,24,46, 0.23 ,22,73,40,135, 0.68 ,48,78,34,160, 0.80 ,57,48,31,136, 0.68 ,53,78,22,153, 0.77 ,54,32,32,118, 0.59 ,748, 0.62 ,visual,2,Study more
ST-337,36,24,60, 0.30 ,41,24,21,86, 0.43 ,50,75,70,195, 0.98 ,28,79,23,130, 0.65 ,48,55,28,131, 0.66 ,74,49,28,151, 0.76 ,753, 0.63 ,auditory,5,Join study group
ST-338,23,76,99, 0.50 ,25,46,76,147, 0.74 ,47,64,65,176, 0.88 ,21,45,25,91, 0.46 ,32,44,28,104, 0.52 ,62,60,39,161, 0.81 ,778, 0.65 ,auditory,5,Practice regularly
ST-339,74,86,160, 0.80 ,33,21,39,93, 0.47 ,24,51,23,98, 0.49 ,68,34,20,122, 0.61 ,70,73,23,166, 0.83 ,57,62,31,150, 0.75 ,789, 0.66 ,kinesthetic,2,Join study group
ST-340,74,96,170, 0.85 ,43,28,40,111, 0.56 ,26,76,25,127, 0.64 ,66,54,29,149, 0.75 ,51,59,21,131, 0.66 ,34,20,21,75, 0.38 ,763, 0.64 ,auditory,1,Study more
ST-341,41,68,109, 0.55 ,45,34,59,138, 0.69 ,41,27,43,111, 0.56 ,50,40,21,111, 0.56 ,77,66,37,180, 0.90 ,76,44,31,151, 0.76 ,800, 0.67 ,auditory,5,Join study group
ST-342,75,22,97, 0.49 ,25,66,38,129, 0.65 ,20,70,69,159, 0.80 ,66,65,24,155, 0.78 ,70,65,28,163, 0.82 ,55,55,23,133, 0.67 ,836, 0.70 ,kinesthetic,5,Join study group
ST-343,90,59,149, 0.75 ,39,65,49,153, 0.77 ,59,27,24,110, 0.55 ,74,56,33,163, 0.82 ,56,66,37,159, 0.80 ,77,73,23,173, 0.87 ,907, 0.76 ,visual,3,Practice regularly
ST-344,51,98,149, 0.75 ,50,46,34,130, 0.65 ,46,42,59,147, 0.74 ,24,26,29,79, 0.40 ,47,71,29,147, 0.74 ,29,36,37,102, 0.51 ,754, 0.63 ,auditory,4,Ask questions
ST-345,61,59,120, 0.60 ,34,78,74,186, 0.93 ,21,54,52,127, 0.64 ,32,67,33,132, 0.66 ,40,20,29,89, 0.45 ,42,40,24,106, 0.53 ,760, 0.63 ,auditory,2,Study more
ST-346,29,76,105, 0.53 ,39,57,29,125, 0.63 ,32,74,63,169, 0.85 ,48,35,39,122, 0.61 ,46,40,21,107, 0.54 ,73,22,30,125, 0.63 ,753, 0.63 ,kinesthetic,5,Join study group
ST-347,62,49,111, 0.56 ,43,34,28,105, 0.53 ,32,61,31,124, 0.62 ,41,61,31,133, 0.67 ,79,52,29,160, 0.80 ,28,78,36,142, 0.71 ,775, 0.65 ,visual,4,Ask questions
ST-348,23,54,77, 0.39 ,51,32,30,113, 0.57 ,50,46,26,122, 0.61 ,69,71,32,172, 0.86 ,77,78,20,175, 0.88 ,51,79,35,165, 0.83 ,824, 0.69 ,auditory,3,Join study group
ST-349,77,21,98, 0.49 ,22,46,65,133, 0.67 ,53,31,52,136, 0.68 ,40,41,27,108, 0.54 ,53,40,27,120, 0.60 ,52,49,37,138, 0.69 ,733, 0.61 ,auditory,5,Study more
ST-350,72,47,119, 0.60 ,53,32,68,153, 0.77 ,55,35,28,118, 0.59 ,38,76,20,134, 0.67 ,25,31,34,90, 0.45 ,57,36,24,117, 0.59 ,731, 0.61 ,kinesthetic,4,Join study group
ST-351,79,83,162, 0.81 ,22,42,66,130, 0.65 ,40,26,68,134, 0.67 ,27,24,27,78, 0.39 ,72,59,28,159, 0.80 ,68,62,35,165, 0.83 ,828, 0.69 ,kinesthetic,2,Practice regularly
ST-352,41,40,81, 0.41 ,55,60,45,160, 0.80 ,37,39,70,146, 0.73 ,79,40,29,148, 0.74 ,69,61,21,151, 0.76 ,70,43,28,141, 0.71 ,827, 0.69 ,auditory,1,Practice regularly
ST-353,66,37,103, 0.52 ,56,72,43,171, 0.86 ,59,74,29,162, 0.81 ,51,55,34,140, 0.70 ,76,73,27,176, 0.88 ,47,70,31,148, 0.74 ,900, 0.75 ,visual,4,Ask questions
ST-354,39,29,68, 0.34 ,45,36,33,114, 0.57 ,53,72,68,193, 0.97 ,30,75,23,128, 0.64 ,75,30,37,142, 0.71 ,60,27,35,122, 0.61 ,767, 0.64 ,auditory,4,Join study group
ST-355,34,36,70, 0.35 ,36,43,23,102, 0.51 ,23,34,55,112, 0.56 ,42,78,33,153, 0.77 ,74,35,21,130, 0.65 ,45,76,29,150, 0.75 ,717, 0.60 ,visual,5,Join study group
ST-356,49,93,142, 0.71 ,55,55,20,130, 0.65 ,37,49,47,133, 0.67 ,22,25,22,69, 0.35 ,43,76,30,149, 0.75 ,72,63,32,167, 0.84 ,790, 0.66 ,visual,4,Ask questions
ST-357,53,78,131, 0.66 ,58,76,65,199, 1.00 ,41,71,32,144, 0.72 ,22,55,20,97, 0.49 ,68,35,32,135, 0.68 ,79,56,31,166, 0.83 ,872, 0.73 ,kinesthetic,5,Study more
ST-358,76,69,145, 0.73 ,46,65,49,160, 0.80 ,41,55,23,119, 0.60 ,25,48,22,95, 0.48 ,60,55,39,154, 0.77 ,37,41,26,104, 0.52 ,777, 0.65 ,kinesthetic,5,Join study group
ST-359,39,67,106, 0.53 ,36,47,46,129, 0.65 ,27,23,62,112, 0.56 ,44,44,24,112, 0.56 ,30,20,21,71, 0.36 ,52,51,33,136, 0.68 ,666, 0.56 ,auditory,4,Study more
ST-360,86,72,158, 0.79 ,25,37,78,140, 0.70 ,39,33,42,114, 0.57 ,24,58,24,106, 0.53 ,22,67,29,118, 0.59 ,28,26,29,83, 0.42 ,719, 0.60 ,auditory,3,Study more
ST-361,75,41,116, 0.58 ,58,61,31,150, 0.75 ,20,20,32,72, 0.36 ,21,30,25,76, 0.38 ,56,55,34,145, 0.73 ,71,36,26,133, 0.67 ,692, 0.58 ,visual,4,Study more
ST-362,61,44,105, 0.53 ,55,50,20,125, 0.63 ,59,41,25,125, 0.63 ,26,34,29,89, 0.45 ,33,28,36,97, 0.49 ,52,59,28,139, 0.70 ,680, 0.57 ,visual,3,Practice regularly
ST-363,66,38,104, 0.52 ,58,64,65,187, 0.94 ,20,39,36,95, 0.48 ,33,25,30,88, 0.44 ,43,43,21,107, 0.54 ,56,52,23,131, 0.66 ,712, 0.59 ,auditory,4,Ask questions
ST-364,49,66,115, 0.58 ,31,38,53,122, 0.61 ,20,44,74,138, 0.69 ,55,29,24,108, 0.54 ,75,42,35,152, 0.76 ,66,29,26,121, 0.61 ,756, 0.63 ,visual,1,Practice regularly
ST-365,51,25,76, 0.38 ,25,78,20,123, 0.62 ,22,69,61,152, 0.76 ,32,28,25,85, 0.43 ,45,45,39,129, 0.65 ,20,57,29,106, 0.53 ,671, 0.56 ,kinesthetic,4,Practice regularly
ST-366,83,38,121, 0.61 ,46,44,44,134, 0.67 ,47,44,72,163, 0.82 ,36,72,33,141, 0.71 ,54,47,20,121, 0.61 ,52,39,38,129, 0.65 ,809, 0.67 ,visual,5,Join study group
ST-367,79,77,156, 0.78 ,48,34,47,129, 0.65 ,29,52,21,102, 0.51 ,64,41,23,128, 0.64 ,51,49,28,128, 0.64 ,68,67,37,172, 0.86 ,815, 0.68 ,kinesthetic,4,Ask questions
ST-368,88,53,141, 0.71 ,27,44,33,104, 0.52 ,49,56,70,175, 0.88 ,60,51,33,144, 0.72 ,46,43,39,128, 0.64 ,75,50,32,157, 0.79 ,849, 0.71 ,visual,3,Join study group
ST-369,99,36,135, 0.68 ,32,76,24,132, 0.66 ,37,70,29,136, 0.68 ,36,68,33,137, 0.69 ,77,53,20,150, 0.75 ,46,24,28,98, 0.49 ,788, 0.66 ,visual,2,Join study group
ST-370,88,23,111, 0.56 ,49,67,68,184, 0.92 ,50,50,78,178, 0.89 ,66,26,25,117, 0.59 ,35,22,28,85, 0.43 ,68,72,27,167, 0.84 ,842, 0.70 ,kinesthetic,5,Study more
ST-371,48,95,143, 0.72 ,55,22,70,147, 0.74 ,58,31,20,109, 0.55 ,27,65,29,121, 0.61 ,66,44,30,140, 0.70 ,66,60,23,149, 0.75 ,809, 0.67 ,visual,5,Practice regularly
ST-372,89,25,114, 0.57 ,52,68,32,152, 0.76 ,27,78,56,161, 0.81 ,70,61,38,169, 0.85 ,36,48,26,110, 0.55 ,43,70,35,148, 0.74 ,854, 0.71 ,kinesthetic,1,Practice regularly
ST-373,35,80,115, 0.58 ,56,36,33,125, 0.63 ,32,25,42,99, 0.50 ,30,78,38,146, 0.73 ,34,75,37,146, 0.73 ,42,30,22,94, 0.47 ,725, 0.60 ,kinesthetic,5,Practice regularly
ST-374,90,20,110, 0.55 ,46,78,50,174, 0.87 ,35,45,48,128, 0.64 ,54,69,39,162, 0.81 ,54,52,23,129, 0.65 ,56,72,37,165, 0.83 ,868, 0.72 ,auditory,4,Practice regularly
ST-375,91,25,116, 0.58 ,39,79,29,147, 0.74 ,56,31,42,129, 0.65 ,20,66,21,107, 0.54 ,26,61,25,112, 0.56 ,47,50,33,130, 0.65 ,741, 0.62 ,auditory,4,Study more
ST-376,32,60,92, 0.46 ,49,35,59,143, 0.72 ,30,41,63,134, 0.67 ,37,61,29,127, 0.64 ,72,46,39,157, 0.79 ,74,79,35,188, 0.94 ,841, 0.70 ,visual,5,Study more
ST-377,39,49,88, 0.44 ,50,24,31,105, 0.53 ,39,47,23,109, 0.55 ,24,37,26,87, 0.44 ,46,45,26,117, 0.59 ,71,53,34,158, 0.79 ,664, 0.55 ,visual,1,Practice regularly
ST-378,57,95,152, 0.76 ,24,27,42,93, 0.47 ,41,72,33,146, 0.73 ,75,55,20,150, 0.75 ,56,55,30,141, 0.71 ,34,59,21,114, 0.57 ,796, 0.66 ,kinesthetic,5,Practice regularly
ST-379,28,84,112, 0.56 ,45,28,38,111, 0.56 ,30,24,66,120, 0.60 ,49,20,34,103, 0.52 ,39,23,22,84, 0.42 ,79,67,38,184, 0.92 ,714, 0.60 ,kinesthetic,1,Study more
ST-380,28,79,107, 0.54 ,59,33,74,166, 0.83 ,24,78,72,174, 0.87 ,59,33,34,126, 0.63 ,37,78,32,147, 0.74 ,32,23,35,90, 0.45 ,810, 0.68 ,visual,1,Practice regularly
ST-381,35,88,123, 0.62 ,36,44,31,111, 0.56 ,39,73,65,177, 0.89 ,43,38,36,117, 0.59 ,46,73,25,144, 0.72 ,36,52,28,116, 0.58 ,788, 0.66 ,kinesthetic,3,Join study group
ST-382,37,20,57, 0.29 ,59,79,40,178, 0.89 ,26,67,64,157, 0.79 ,74,39,20,133, 0.67 ,24,70,35,129, 0.65 ,48,29,39,116, 0.58 ,770, 0.64 ,visual,2,Study more
ST-383,82,82,164, 0.82 ,27,30,54,111, 0.56 ,51,46,29,126, 0.63 ,44,50,37,131, 0.66 ,69,64,35,168, 0.84 ,40,74,33,147, 0.74 ,847, 0.71 ,visual,4,Study more
ST-384,94,95,189, 0.95 ,44,49,22,115, 0.58 ,54,29,60,143, 0.72 ,73,66,30,169, 0.85 ,41,66,35,142, 0.71 ,25,24,37,86, 0.43 ,844, 0.70 ,visual,1,Join study group
ST-385,84,59,143, 0.72 ,39,24,72,135, 0.68 ,51,44,33,128, 0.64 ,67,52,22,141, 0.71 ,40,47,33,120, 0.60 ,42,38,23,103, 0.52 ,770, 0.64 ,auditory,3,Study more
ST-386,89,30,119, 0.60 ,50,24,41,115, 0.58 ,47,49,47,143, 0.72 ,70,49,24,143, 0.72 ,74,52,30,156, 0.78 ,71,23,38,132, 0.66 ,808, 0.67 ,auditory,3,Study more
ST-387,49,88,137, 0.69 ,23,76,67,166, 0.83 ,21,43,74,138, 0.69 ,29,54,24,107, 0.54 ,52,63,35,150, 0.75 ,60,76,30,166, 0.83 ,864, 0.72 ,kinesthetic,2,Study more
ST-388,59,69,128, 0.64 ,24,37,74,135, 0.68 ,47,77,22,146, 0.73 ,35,31,22,88, 0.44 ,28,20,39,87, 0.44 ,21,30,21,72, 0.36 ,656, 0.55 ,visual,3,Study more
ST-389,95,59,154, 0.77 ,32,41,76,149, 0.75 ,39,42,67,148, 0.74 ,52,58,38,148, 0.74 ,70,63,28,161, 0.81 ,33,21,24,78, 0.39 ,838, 0.70 ,kinesthetic,3,Join study group
ST-390,48,85,133, 0.67 ,51,57,64,172, 0.86 ,46,37,42,125, 0.63 ,58,50,32,140, 0.70 ,62,73,35,170, 0.85 ,24,64,29,117, 0.59 ,857, 0.71 ,visual,3,Study more
ST-391,29,22,51, 0.26 ,59,30,41,130, 0.65 ,43,40,33,116, 0.58 ,51,20,23,94, 0.47 ,63,68,32,163, 0.82 ,53,53,35,141, 0.71 ,695, 0.58 ,visual,2,Ask questions
ST-392,37,61,98, 0.49 ,29,26,70,125, 0.63 ,39,24,63,126, 0.63 ,42,65,28,135, 0.68 ,60,78,20,158, 0.79 ,36,79,23,138, 0.69 ,780, 0.65 ,visual,3,Join study group
ST-393,66,33,99, 0.50 ,36,34,53,123, 0.62 ,33,21,35,89, 0.45 ,55,71,31,157, 0.79 ,31,26,36,93, 0.47 ,67,75,29,171, 0.86 ,732, 0.61 ,kinesthetic,2,Study more
ST-394,87,29,116, 0.58 ,33,56,44,133, 0.67 ,48,56,27,131, 0.66 ,42,35,28,105, 0.53 ,78,28,38,144, 0.72 ,58,78,33,169, 0.85 ,798, 0.67 ,visual,1,Practice regularly
ST-395,53,43,96, 0.48 ,24,59,73,156, 0.78 ,31,31,76,138, 0.69 ,36,65,20,121, 0.61 ,79,47,22,148, 0.74 ,40,68,34,142, 0.71 ,801, 0.67 ,kinesthetic,5,Practice regularly
ST-396,28,44,72, 0.36 ,42,74,74,190, 0.95 ,42,48,31,121, 0.61 ,75,67,23,165, 0.83 ,40,62,32,134, 0.67 ,43,63,28,134, 0.67 ,816, 0.68 ,kinesthetic,1,Practice regularly
ST-397,49,22,71, 0.36 ,23,43,60,126, 0.63 ,53,20,39,112, 0.56 ,63,70,39,172, 0.86 ,45,56,38,139, 0.70 ,43,73,33,149, 0.75 ,769, 0.64 ,auditory,5,Join study group
ST-398,84,35,119, 0.60 ,30,28,55,113, 0.57 ,31,43,56,130, 0.65 ,21,68,24,113, 0.57 ,33,77,22,132, 0.66 ,58,35,32,125, 0.63 ,732, 0.61 ,kinesthetic,2,Study more
ST-399,85,59,144, 0.72 ,37,76,70,183, 0.92 ,25,37,75,137, 0.69 ,65,50,20,135, 0.68 ,54,52,30,136, 0.68 ,74,61,33,168, 0.84 ,903, 0.75 ,auditory,4,Practice regularly
ST-400,82,42,124, 0.62 ,27,67,20,114, 0.57 ,37,33,61,131, 0.66 ,35,41,39,115, 0.58 ,68,53,29,150, 0.75 ,44,31,28,103, 0.52 ,737, 0.61 ,kinesthetic,2,Join study group
ST-401,48,23,71, 0.36 ,21,32,46,99, 0.50 ,50,35,39,124, 0.62 ,23,55,26,104, 0.52 ,22,68,30,120, 0.60 ,42,20,22,84, 0.42 ,602, 0.50 ,kinesthetic,3,Practice regularly
ST-402,81,80,161, 0.81 ,25,72,58,155, 0.78 ,22,32,46,100, 0.50 ,29,63,39,131, 0.66 ,40,47,32,119, 0.60 ,42,22,27,91, 0.46 ,757, 0.63 ,kinesthetic,3,Ask questions
ST-403,90,87,177, 0.89 ,38,65,25,128, 0.64 ,40,27,74,141, 0.71 ,75,78,29,182, 0.91 ,58,21,25,104, 0.52 ,21,74,39,134, 0.67 ,866, 0.72 ,visual,1,Practice regularly
ST-404,75,36,111, 0.56 ,40,35,76,151, 0.76 ,59,62,55,176, 0.88 ,56,60,25,141, 0.71 ,73,51,24,148, 0.74 ,53,25,30,108, 0.54 ,835, 0.70 ,kinesthetic,1,Practice regularly
ST-405,76,93,169, 0.85 ,47,27,76,150, 0.75 ,25,67,69,161, 0.81 ,45,71,22,138, 0.69 ,67,32,29,128, 0.64 ,57,31,26,114, 0.57 ,860, 0.72 ,visual,4,Practice regularly
ST-406,37,33,70, 0.35 ,47,36,49,132, 0.66 ,48,50,51,149, 0.75 ,22,30,29,81, 0.41 ,47,26,34,107, 0.54 ,25,39,22,86, 0.43 ,625, 0.52 ,visual,3,Join study group
ST-407,88,32,120, 0.60 ,28,22,31,81, 0.41 ,33,67,34,134, 0.67 ,34,48,33,115, 0.58 ,71,78,24,173, 0.87 ,46,76,31,153, 0.77 ,776, 0.65 ,kinesthetic,1,Practice regularly
ST-408,60,43,103, 0.52 ,34,30,33,97, 0.49 ,26,57,74,157, 0.79 ,51,51,23,125, 0.63 ,52,21,21,94, 0.47 ,30,41,27,98, 0.49 ,674, 0.56 ,kinesthetic,5,Ask questions
ST-409,28,24,52, 0.26 ,34,23,35,92, 0.46 ,31,60,56,147, 0.74 ,68,22,32,122, 0.61 ,63,37,32,132, 0.66 ,47,69,30,146, 0.73 ,691, 0.58 ,auditory,2,Join study group
ST-410,83,23,106, 0.53 ,49,49,42,140, 0.70 ,24,22,23,69, 0.35 ,20,58,37,115, 0.58 ,21,59,37,117, 0.59 ,73,43,32,148, 0.74 ,695, 0.58 ,auditory,3,Practice regularly
ST-411,82,91,173, 0.87 ,32,47,64,143, 0.72 ,22,21,59,102, 0.51 ,43,27,27,97, 0.49 ,32,41,27,100, 0.50 ,79,29,24,132, 0.66 ,747, 0.62 ,visual,4,Join study group
ST-412,52,43,95, 0.48 ,30,38,70,138, 0.69 ,29,57,70,156, 0.78 ,26,48,33,107, 0.54 ,40,40,36,116, 0.58 ,76,51,33,160, 0.80 ,772, 0.64 ,kinesthetic,5,Join study group
ST-413,29,53,82, 0.41 ,48,35,31,114, 0.57 ,55,21,20,96, 0.48 ,56,26,35,117, 0.59 ,23,31,23,77, 0.39 ,31,52,32,115, 0.58 ,601, 0.50 ,kinesthetic,3,Ask questions
ST-414,65,55,120, 0.60 ,28,66,62,156, 0.78 ,28,38,68,134, 0.67 ,76,53,26,155, 0.78 ,56,58,29,143, 0.72 ,50,23,36,109, 0.55 ,817, 0.68 ,auditory,3,Ask questions
ST-415,26,72,98, 0.49 ,49,59,63,171, 0.86 ,52,38,35,125, 0.63 ,30,46,24,100, 0.50 ,62,35,25,122, 0.61 ,73,77,22,172, 0.86 ,788, 0.66 ,auditory,3,Ask questions
ST-416,38,68,106, 0.53 ,53,68,77,198, 0.99 ,53,26,40,119, 0.60 ,56,35,25,116, 0.58 ,32,67,20,119, 0.60 ,61,30,33,124, 0.62 ,782, 0.65 ,auditory,5,Practice regularly
ST-417,80,62,142, 0.71 ,20,69,38,127, 0.64 ,32,74,78,184, 0.92 ,56,54,32,142, 0.71 ,46,42,35,123, 0.62 ,48,27,39,114, 0.57 ,832, 0.69 ,kinesthetic,1,Practice regularly
ST-418,93,76,169, 0.85 ,49,64,40,153, 0.77 ,43,37,22,102, 0.51 ,62,45,33,140, 0.70 ,41,59,26,126, 0.63 ,77,33,33,143, 0.72 ,833, 0.69 ,auditory,2,Join study group
ST-419,85,45,130, 0.65 ,33,74,40,147, 0.74 ,46,62,46,154, 0.77 ,20,67,20,107, 0.54 ,66,30,22,118, 0.59 ,29,59,32,120, 0.60 ,776, 0.65 ,visual,2,Ask questions
ST-420,23,63,86, 0.43 ,59,51,65,175, 0.88 ,24,36,34,94, 0.47 ,54,64,30,148, 0.74 ,28,32,22,82, 0.41 ,26,39,39,104, 0.52 ,689, 0.57 ,auditory,5,Ask questions
ST-421,32,77,109, 0.55 ,34,40,24,98, 0.49 ,57,64,26,147, 0.74 ,46,36,23,105, 0.53 ,20,51,29,100, 0.50 ,60,60,37,157, 0.79 ,716, 0.60 ,auditory,1,Practice regularly
ST-422,93,89,182, 0.91 ,24,38,21,83, 0.42 ,22,40,21,83, 0.42 ,41,66,28,135, 0.68 ,74,74,32,180, 0.90 ,78,38,29,145, 0.73 ,808, 0.67 ,auditory,1,Join study group
ST-423,59,95,154, 0.77 ,36,57,57,150, 0.75 ,30,47,36,113, 0.57 ,28,59,22,109, 0.55 ,39,67,25,131, 0.66 ,42,61,30,133, 0.67 ,790, 0.66 ,auditory,4,Practice regularly
ST-424,50,49,99, 0.50 ,48,30,44,122, 0.61 ,26,46,32,104, 0.52 ,53,63,22,138, 0.69 ,76,44,26,146, 0.73 ,37,32,31,100, 0.50 ,709, 0.59 ,auditory,3,Study more
ST-425,71,79,150, 0.75 ,56,40,45,141, 0.71 ,48,50,65,163, 0.82 ,47,79,24,150, 0.75 ,20,62,37,119, 0.60 ,77,47,28,152, 0.76 ,875, 0.73 ,kinesthetic,2,Join study group
ST-426,53,92,145, 0.73 ,38,37,31,106, 0.53 ,40,74,47,161, 0.81 ,28,70,33,131, 0.66 ,38,78,27,143, 0.72 ,58,20,33,111, 0.56 ,797, 0.66 ,kinesthetic,5,Join study group
ST-427,27,44,71, 0.36 ,57,67,51,175, 0.88 ,55,62,32,149, 0.75 ,26,59,33,118, 0.59 ,36,72,21,129, 0.65 ,44,69,39,152, 0.76 ,794, 0.66 ,visual,3,Ask questions
ST-428,46,93,139, 0.70 ,43,57,66,166, 0.83 ,20,37,50,107, 0.54 ,24,46,33,103, 0.52 ,57,76,23,156, 0.78 ,41,79,33,153, 0.77 ,824, 0.69 ,auditory,5,Ask questions
ST-429,53,97,150, 0.75 ,52,72,21,145, 0.73 ,48,33,68,149, 0.75 ,32,66,23,121, 0.61 ,37,46,23,106, 0.53 ,34,68,20,122, 0.61 ,793, 0.66 ,auditory,3,Join study group
ST-430,48,68,116, 0.58 ,39,68,21,128, 0.64 ,58,64,43,165, 0.83 ,56,30,30,116, 0.58 ,21,57,22,100, 0.50 ,56,41,23,120, 0.60 ,745, 0.62 ,auditory,4,Study more
ST-431,36,96,132, 0.66 ,39,28,35,102, 0.51 ,21,42,53,116, 0.58 ,39,44,23,106, 0.53 ,57,26,26,109, 0.55 ,77,77,21,175, 0.88 ,740, 0.62 ,visual,5,Study more
ST-432,98,88,186, 0.93 ,51,30,46,127, 0.64 ,30,34,63,127, 0.64 ,50,64,33,147, 0.74 ,26,74,23,123, 0.62 ,22,27,22,71, 0.36 ,781, 0.65 ,auditory,3,Ask questions
ST-433,93,49,142, 0.71 ,37,59,38,134, 0.67 ,21,47,48,116, 0.58 ,25,29,36,90, 0.45 ,77,41,29,147, 0.74 ,59,60,29,148, 0.74 ,777, 0.65 ,kinesthetic,3,Study more
ST-434,74,47,121, 0.61 ,36,40,51,127, 0.64 ,52,34,23,109, 0.55 ,34,49,39,122, 0.61 ,33,61,27,121, 0.61 ,77,36,20,133, 0.67 ,733, 0.61 ,visual,3,Practice regularly
ST-435,22,46,68, 0.34 ,33,39,36,108, 0.54 ,58,25,53,136, 0.68 ,27,66,31,124, 0.62 ,38,41,26,105, 0.53 ,77,34,29,140, 0.70 ,681, 0.57 ,visual,1,Join study group
ST-436,77,62,139, 0.70 ,20,61,51,132, 0.66 ,58,75,65,198, 0.99 ,28,74,25,127, 0.64 ,36,51,23,110, 0.55 ,56,46,38,140, 0.70 ,846, 0.71 ,auditory,1,Ask questions
ST-437,99,80,179, 0.90 ,57,36,23,116, 0.58 ,36,24,45,105, 0.53 ,34,79,32,145, 0.73 ,38,40,20,98, 0.49 ,72,48,26,146, 0.73 ,789, 0.66 ,auditory,1,Join study group
ST-438,35,35,70, 0.35 ,50,43,69,162, 0.81 ,24,36,59,119, 0.60 ,26,21,23,70, 0.35 ,56,51,20,127, 0.64 ,45,34,29,108, 0.54 ,656, 0.55 ,auditory,5,Practice regularly
ST-439,21,60,81, 0.41 ,49,66,51,166, 0.83 ,56,22,39,117, 0.59 ,52,68,30,150, 0.75 ,76,40,36,152, 0.76 ,79,79,20,178, 0.89 ,844, 0.70 ,auditory,4,Join study group
ST-440,30,95,125, 0.63 ,25,26,63,114, 0.57 ,28,38,31,97, 0.49 ,39,44,22,105, 0.53 ,60,64,38,162, 0.81 ,24,20,20,64, 0.32 ,667, 0.56 ,auditory,2,Join study group
ST-441,59,80,139, 0.70 ,29,36,57,122, 0.61 ,36,40,43,119, 0.60 ,50,42,35,127, 0.64 ,74,44,22,140, 0.70 ,79,39,27,145, 0.73 ,792, 0.66 ,kinesthetic,2,Join study group
ST-442,93,76,169, 0.85 ,39,57,59,155, 0.78 ,38,23,55,116, 0.58 ,59,63,32,154, 0.77 ,35,39,24,98, 0.49 ,48,42,27,117, 0.59 ,809, 0.67 ,kinesthetic,2,Study more
ST-443,74,37,111, 0.56 ,24,56,75,155, 0.78 ,59,35,22,116, 0.58 ,29,52,25,106, 0.53 ,43,46,21,110, 0.55 ,67,39,31,137, 0.69 ,735, 0.61 ,visual,2,Ask questions
ST-444,94,62,156, 0.78 ,38,41,53,132, 0.66 ,45,30,75,150, 0.75 ,76,39,22,137, 0.69 ,39,28,21,88, 0.44 ,52,40,20,112, 0.56 ,775, 0.65 ,kinesthetic,4,Practice regularly
ST-445,75,45,120, 0.60 ,45,71,59,175, 0.88 ,45,79,57,181, 0.91 ,36,72,23,131, 0.66 ,74,35,28,137, 0.69 ,34,59,37,130, 0.65 ,874, 0.73 ,kinesthetic,1,Study more
ST-446,32,86,118, 0.59 ,53,79,49,181, 0.91 ,52,57,61,170, 0.85 ,41,55,36,132, 0.66 ,77,78,25,180, 0.90 ,73,34,39,146, 0.73 ,927, 0.77 ,kinesthetic,1,Practice regularly
ST-447,56,77,133, 0.67 ,50,25,65,140, 0.70 ,46,61,68,175, 0.88 ,24,30,20,74, 0.37 ,79,41,30,150, 0.75 ,42,44,35,121, 0.61 ,793, 0.66 ,auditory,3,Ask questions
ST-448,62,99,161, 0.81 ,37,32,62,131, 0.66 ,43,63,56,162, 0.81 ,54,42,24,120, 0.60 ,79,67,35,181, 0.91 ,33,23,24,80, 0.40 ,835, 0.70 ,auditory,4,Study more
ST-449,52,53,105, 0.53 ,44,25,59,128, 0.64 ,45,52,34,131, 0.66 ,20,77,35,132, 0.66 ,28,45,37,110, 0.55 ,42,68,27,137, 0.69 ,743, 0.62 ,kinesthetic,4,Join study group
ST-450,67,26,93, 0.47 ,57,51,31,139, 0.70 ,27,20,62,109, 0.55 ,56,24,23,103, 0.52 ,66,52,26,144, 0.72 ,33,30,37,100, 0.50 ,688, 0.57 ,auditory,5,Study more
ST-451,67,63,130, 0.65 ,33,42,37,112, 0.56 ,31,36,43,110, 0.55 ,68,49,26,143, 0.72 ,71,64,31,166, 0.83 ,60,28,36,124, 0.62 ,785, 0.65 ,kinesthetic,5,Ask questions
ST-452,83,34,117, 0.59 ,48,31,23,102, 0.51 ,53,69,55,177, 0.89 ,70,36,27,133, 0.67 ,76,77,33,186, 0.93 ,75,39,22,136, 0.68 ,851, 0.71 ,auditory,3,Ask questions
ST-453,54,99,153, 0.77 ,33,44,34,111, 0.56 ,53,51,50,154, 0.77 ,31,27,36,94, 0.47 ,41,41,30,112, 0.56 ,29,71,20,120, 0.60 ,744, 0.62 ,kinesthetic,2,Practice regularly
ST-454,91,87,178, 0.89 ,48,38,38,124, 0.62 ,36,62,36,134, 0.67 ,37,68,25,130, 0.65 ,77,70,21,168, 0.84 ,61,77,26,164, 0.82 ,898, 0.75 ,visual,3,Join study group
ST-455,79,62,141, 0.71 ,44,72,48,164, 0.82 ,22,59,38,119, 0.60 ,77,40,34,151, 0.76 ,61,42,21,124, 0.62 ,70,59,25,154, 0.77 ,853, 0.71 ,auditory,5,Ask questions
ST-456,40,76,116, 0.58 ,27,26,34,87, 0.44 ,43,68,25,136, 0.68 ,23,30,36,89, 0.45 ,35,49,20,104, 0.52 ,68,49,28,145, 0.73 ,677, 0.56 ,visual,1,Ask questions
ST-457,24,47,71, 0.36 ,37,55,57,149, 0.75 ,52,51,25,128, 0.64 ,77,20,26,123, 0.62 ,62,79,37,178, 0.89 ,47,63,29,139, 0.70 ,788, 0.66 ,kinesthetic,5,Ask questions
ST-458,96,30,126, 0.63 ,46,68,46,160, 0.80 ,59,59,55,173, 0.87 ,56,70,31,157, 0.79 ,38,69,29,136, 0.68 ,68,50,25,143, 0.72 ,895, 0.75 ,kinesthetic,5,Ask questions
ST-459,49,56,105, 0.53 ,54,60,50,164, 0.82 ,38,79,56,173, 0.87 ,30,56,38,124, 0.62 ,28,75,36,139, 0.70 ,31,45,31,107, 0.54 ,812, 0.68 ,kinesthetic,1,Join study group
ST-460,94,67,161, 0.81 ,26,53,20,99, 0.50 ,56,22,60,138, 0.69 ,20,43,33,96, 0.48 ,57,32,39,128, 0.64 ,62,23,20,105, 0.53 ,727, 0.61 ,auditory,5,Study more
ST-461,80,25,105, 0.53 ,54,47,45,146, 0.73 ,39,48,61,148, 0.74 ,49,54,27,130, 0.65 ,46,62,31,139, 0.70 ,24,45,21,90, 0.45 ,758, 0.63 ,visual,3,Ask questions
ST-462,43,27,70, 0.35 ,49,20,61,130, 0.65 ,24,69,75,168, 0.84 ,70,61,39,170, 0.85 ,26,31,30,87, 0.44 ,55,31,38,124, 0.62 ,749, 0.62 ,auditory,4,Practice regularly
ST-463,30,36,66, 0.33 ,58,67,54,179, 0.90 ,43,24,62,129, 0.65 ,49,50,30,129, 0.65 ,29,57,28,114, 0.57 ,56,42,31,129, 0.65 ,746, 0.62 ,auditory,2,Study more
ST-464,78,73,151, 0.76 ,56,40,28,124, 0.62 ,40,34,54,128, 0.64 ,29,63,36,128, 0.64 ,77,54,32,163, 0.82 ,48,67,30,145, 0.73 ,839, 0.70 ,kinesthetic,4,Join study group
ST-465,32,71,103, 0.52 ,33,49,42,124, 0.62 ,29,22,76,127, 0.64 ,25,20,26,71, 0.36 ,20,54,39,113, 0.57 ,33,38,32,103, 0.52 ,641, 0.53 ,auditory,2,Ask questions
ST-466,89,56,145, 0.73 ,54,23,59,136, 0.68 ,53,24,54,131, 0.66 ,29,51,31,111, 0.56 ,74,61,38,173, 0.87 ,44,23,34,101, 0.51 ,797, 0.66 ,visual,1,Ask questions
ST-467,67,92,159, 0.80 ,28,47,56,131, 0.66 ,57,27,51,135, 0.68 ,37,70,35,142, 0.71 ,27,78,36,141, 0.71 ,47,28,20,95, 0.48 ,803, 0.67 ,kinesthetic,5,Practice regularly
ST-468,68,36,104, 0.52 ,44,60,70,174, 0.87 ,59,33,50,142, 0.71 ,72,75,36,183, 0.92 ,63,46,30,139, 0.70 ,63,24,30,117, 0.59 ,859, 0.72 ,auditory,4,Practice regularly
ST-469,84,25,109, 0.55 ,32,31,34,97, 0.49 ,47,28,70,145, 0.73 ,20,77,30,127, 0.64 ,43,52,25,120, 0.60 ,79,26,35,140, 0.70 ,738, 0.62 ,visual,5,Join study group
ST-470,53,64,117, 0.59 ,44,53,56,153, 0.77 ,22,70,49,141, 0.71 ,52,38,27,117, 0.59 ,23,75,21,119, 0.60 ,20,30,36,86, 0.43 ,733, 0.61 ,kinesthetic,2,Ask questions
ST-471,52,88,140, 0.70 ,33,54,37,124, 0.62 ,32,33,25,90, 0.45 ,60,75,32,167, 0.84 ,57,25,30,112, 0.56 ,21,60,38,119, 0.60 ,752, 0.63 ,kinesthetic,2,Study more
ST-472,42,62,104, 0.52 ,47,50,72,169, 0.85 ,35,63,65,163, 0.82 ,66,35,24,125, 0.63 ,40,39,27,106, 0.53 ,72,43,33,148, 0.74 ,815, 0.68 ,kinesthetic,1,Practice regularly
ST-473,36,69,105, 0.53 ,59,41,24,124, 0.62 ,35,63,51,149, 0.75 ,42,33,23,98, 0.49 ,50,32,22,104, 0.52 ,76,32,32,140, 0.70 ,720, 0.60 ,auditory,1,Ask questions
ST-474,24,22,46, 0.23 ,34,31,45,110, 0.55 ,34,47,29,110, 0.55 ,41,78,26,145, 0.73 ,71,28,33,132, 0.66 ,49,48,20,117, 0.59 ,660, 0.55 ,visual,1,Study more
ST-475,37,65,102, 0.51 ,35,54,50,139, 0.70 ,34,47,41,122, 0.61 ,43,43,32,118, 0.59 ,32,53,37,122, 0.61 ,21,29,30,80, 0.40 ,683, 0.57 ,kinesthetic,1,Practice regularly
ST-476,27,24,51, 0.26 ,50,74,50,174, 0.87 ,36,62,44,142, 0.71 ,47,26,21,94, 0.47 ,72,39,32,143, 0.72 ,49,23,30,102, 0.51 ,706, 0.59 ,kinesthetic,2,Ask questions
ST-477,91,20,111, 0.56 ,40,41,63,144, 0.72 ,45,30,74,149, 0.75 ,50,62,21,133, 0.67 ,24,54,27,105, 0.53 ,38,64,33,135, 0.68 ,777, 0.65 ,visual,3,Practice regularly
ST-478,90,83,173, 0.87 ,33,22,35,90, 0.45 ,20,34,74,128, 0.64 ,79,62,39,180, 0.90 ,56,44,32,132, 0.66 ,55,66,36,157, 0.79 ,860, 0.72 ,kinesthetic,1,Study more
ST-479,79,85,164, 0.82 ,57,56,50,163, 0.82 ,29,29,62,120, 0.60 ,69,53,33,155, 0.78 ,74,60,20,154, 0.77 ,26,31,34,91, 0.46 ,847, 0.71 ,visual,1,Ask questions
ST-480,73,51,124, 0.62 ,20,24,33,77, 0.39 ,25,77,35,137, 0.69 ,61,78,21,160, 0.80 ,50,30,30,110, 0.55 ,75,37,39,151, 0.76 ,759, 0.63 ,visual,1,Ask questions
ST-481,86,55,141, 0.71 ,31,68,34,133, 0.67 ,33,44,78,155, 0.78 ,68,67,22,157, 0.79 ,50,33,37,120, 0.60 ,70,49,27,146, 0.73 ,852, 0.71 ,kinesthetic,4,Join study group
ST-482,87,29,116, 0.58 ,53,76,62,191, 0.96 ,51,74,68,193, 0.97 ,23,53,25,101, 0.51 ,23,26,33,82, 0.41 ,44,75,23,142, 0.71 ,825, 0.69 ,visual,2,Practice regularly
ST-483,44,36,80, 0.40 ,56,61,61,178, 0.89 ,34,68,57,159, 0.80 ,41,52,33,126, 0.63 ,42,79,24,145, 0.73 ,23,70,29,122, 0.61 ,810, 0.68 ,visual,1,Study more
ST-484,33,23,56, 0.28 ,33,56,36,125, 0.63 ,53,53,79,185, 0.93 ,25,49,23,97, 0.49 ,50,35,24,109, 0.55 ,75,77,32,184, 0.92 ,756, 0.63 ,visual,5,Join study group
ST-485,64,38,102, 0.51 ,32,22,54,108, 0.54 ,40,32,40,112, 0.56 ,64,66,39,169, 0.85 ,55,38,20,113, 0.57 ,60,37,26,123, 0.62 ,727, 0.61 ,kinesthetic,1,Join study group
ST-486,60,81,141, 0.71 ,23,35,44,102, 0.51 ,51,72,44,167, 0.84 ,24,35,34,93, 0.47 ,20,49,32,101, 0.51 ,66,21,34,121, 0.61 ,725, 0.60 ,visual,1,Join study group
ST-487,84,60,144, 0.72 ,38,67,79,184, 0.92 ,37,65,29,131, 0.66 ,23,49,33,105, 0.53 ,77,77,39,193, 0.97 ,61,38,28,127, 0.64 ,884, 0.74 ,auditory,3,Practice regularly
ST-488,80,86,166, 0.83 ,38,39,38,115, 0.58 ,22,73,37,132, 0.66 ,39,75,32,146, 0.73 ,24,42,21,87, 0.44 ,33,22,37,92, 0.46 ,738, 0.62 ,auditory,4,Join study group
ST-489,98,60,158, 0.79 ,32,66,46,144, 0.72 ,57,56,34,147, 0.74 ,52,55,39,146, 0.73 ,67,73,32,172, 0.86 ,21,38,39,98, 0.49 ,865, 0.72 ,visual,2,Practice regularly
ST-490,54,33,87, 0.44 ,54,51,24,129, 0.65 ,59,66,70,195, 0.98 ,78,21,21,120, 0.60 ,57,22,25,104, 0.52 ,22,31,22,75, 0.38 ,710, 0.59 ,kinesthetic,3,Study more
ST-491,31,85,116, 0.58 ,25,23,23,71, 0.36 ,54,53,49,156, 0.78 ,30,69,20,119, 0.60 ,74,27,24,125, 0.63 ,30,79,27,136, 0.68 ,723, 0.60 ,kinesthetic,2,Practice regularly
ST-492,39,35,74, 0.37 ,46,23,51,120, 0.60 ,54,27,74,155, 0.78 ,27,39,34,100, 0.50 ,49,21,36,106, 0.53 ,63,34,33,130, 0.65 ,685, 0.57 ,kinesthetic,1,Study more
ST-493,75,59,134, 0.67 ,22,30,26,78, 0.39 ,21,23,58,102, 0.51 ,32,65,31,128, 0.64 ,37,52,39,128, 0.64 ,32,54,29,115, 0.58 ,685, 0.57 ,auditory,2,Ask questions
ST-494,70,24,94, 0.47 ,23,52,39,114, 0.57 ,40,78,22,140, 0.70 ,77,67,32,176, 0.88 ,63,72,32,167, 0.84 ,38,62,27,127, 0.64 ,818, 0.68 ,visual,3,Study more
ST-495,51,78,129, 0.65 ,58,29,72,159, 0.80 ,57,65,22,144, 0.72 ,27,57,28,112, 0.56 ,54,48,33,135, 0.68 ,55,32,25,112, 0.56 ,791, 0.66 ,auditory,4,Ask questions
ST-496,59,44,103, 0.52 ,45,28,39,112, 0.56 ,32,30,72,134, 0.67 ,35,51,29,115, 0.58 ,24,24,39,87, 0.44 ,40,47,34,121, 0.61 ,672, 0.56 ,kinesthetic,1,Practice regularly
ST-497,72,50,122, 0.61 ,36,73,35,144, 0.72 ,32,58,35,125, 0.63 ,41,68,28,137, 0.69 ,42,36,22,100, 0.50 ,44,35,34,113, 0.57 ,741, 0.62 ,auditory,3,Practice regularly
ST-498,49,70,119, 0.60 ,44,41,37,122, 0.61 ,40,37,70,147, 0.74 ,24,59,23,106, 0.53 ,25,33,20,78, 0.39 ,24,33,22,79, 0.40 ,651, 0.54 ,visual,5,Study more
ST-499,81,84,165, 0.83 ,23,41,38,102, 0.51 ,29,28,52,109, 0.55 ,59,48,21,128, 0.64 ,76,26,31,133, 0.67 ,44,78,24,146, 0.73 ,783, 0.65 ,auditory,2,Study more
ST-500,37,94,131, 0.66 ,49,56,27,132, 0.66 ,53,26,68,147, 0.74 ,26,24,22,72, 0.36 ,62,58,30,150, 0.75 ,23,25,32,80, 0.40 ,712, 0.59 ,kinesthetic,4,Join study group
ST-501,61,87,148, 0.74 ,59,75,21,155, 0.78 ,31,52,52,135, 0.68 ,57,44,23,124, 0.62 ,72,61,23,156, 0.78 ,49,30,29,108, 0.54 ,826, 0.69 ,visual,2,Practice regularly
ST-502,75,85,160, 0.80 ,32,22,35,89, 0.45 ,23,58,66,147, 0.74 ,53,67,24,144, 0.72 ,71,39,26,136, 0.68 ,78,34,38,150, 0.75 ,826, 0.69 ,kinesthetic,2,Study more
ST-503,67,22,89, 0.45 ,31,73,62,166, 0.83 ,28,27,53,108, 0.54 ,78,55,38,171, 0.86 ,59,29,24,112, 0.56 ,78,58,30,166, 0.83 ,812, 0.68 ,visual,3,Study more
ST-504,45,52,97, 0.49 ,54,76,73,203, 1.02 ,38,40,75,153, 0.77 ,37,21,32,90, 0.45 ,41,35,30,106, 0.53 ,61,22,39,122, 0.61 ,771, 0.64 ,kinesthetic,4,Join study group
ST-505,60,75,135, 0.68 ,33,69,62,164, 0.82 ,57,63,60,180, 0.90 ,58,79,24,161, 0.81 ,78,52,27,157, 0.79 ,46,62,29,137, 0.69 ,934, 0.78 ,visual,4,Practice regularly
ST-506,88,49,137, 0.69 ,30,31,49,110, 0.55 ,38,23,40,101, 0.51 ,44,63,33,140, 0.70 ,48,45,27,120, 0.60 ,33,58,22,113, 0.57 ,721, 0.60 ,visual,3,Join study group
ST-507,38,81,119, 0.60 ,36,26,23,85, 0.43 ,30,69,42,141, 0.71 ,53,57,25,135, 0.68 ,21,35,32,88, 0.44 ,50,76,31,157, 0.79 ,725, 0.60 ,auditory,2,Practice regularly
ST-508,44,93,137, 0.69 ,22,32,55,109, 0.55 ,25,69,72,166, 0.83 ,35,48,27,110, 0.55 ,62,47,21,130, 0.65 ,44,36,38,118, 0.59 ,770, 0.64 ,kinesthetic,1,Join study group
ST-509,93,25,118, 0.59 ,58,55,37,150, 0.75 ,39,40,57,136, 0.68 ,36,44,28,108, 0.54 ,60,53,23,136, 0.68 ,57,37,29,123, 0.62 ,771, 0.64 ,kinesthetic,4,Study more
ST-510,86,20,106, 0.53 ,36,39,50,125, 0.63 ,54,71,44,169, 0.85 ,23,59,33,115, 0.58 ,30,66,34,130, 0.65 ,58,22,26,106, 0.53 ,751, 0.63 ,visual,3,Ask questions
ST-511,38,35,73, 0.37 ,22,51,32,105, 0.53 ,59,32,37,128, 0.64 ,46,75,23,144, 0.72 ,60,62,28,150, 0.75 ,63,66,27,156, 0.78 ,756, 0.63 ,visual,4,Ask questions
ST-512,50,85,135, 0.68 ,35,68,48,151, 0.76 ,27,33,24,84, 0.42 ,36,49,32,117, 0.59 ,72,24,28,124, 0.62 ,70,57,39,166, 0.83 ,777, 0.65 ,visual,3,Ask questions
ST-513,22,70,92, 0.46 ,25,51,36,112, 0.56 ,40,57,56,153, 0.77 ,76,27,38,141, 0.71 ,63,26,25,114, 0.57 ,32,73,24,129, 0.65 ,741, 0.62 ,auditory,2,Join study group
ST-514,76,68,144, 0.72 ,26,57,53,136, 0.68 ,38,62,59,159, 0.80 ,49,29,37,115, 0.58 ,30,21,25,76, 0.38 ,68,45,22,135, 0.68 ,765, 0.64 ,visual,2,Join study group
ST-515,46,44,90, 0.45 ,37,47,25,109, 0.55 ,33,29,69,131, 0.66 ,74,69,29,172, 0.86 ,49,40,31,120, 0.60 ,56,66,37,159, 0.80 ,781, 0.65 ,visual,3,Ask questions
ST-516,32,25,57, 0.29 ,42,25,29,96, 0.48 ,20,33,32,85, 0.43 ,79,37,22,138, 0.69 ,43,69,30,142, 0.71 ,79,52,32,163, 0.82 ,681, 0.57 ,kinesthetic,5,Practice regularly
ST-517,61,42,103, 0.52 ,26,36,79,141, 0.71 ,58,58,20,136, 0.68 ,47,32,33,112, 0.56 ,52,25,38,115, 0.58 ,76,40,36,152, 0.76 ,759, 0.63 ,kinesthetic,5,Study more
ST-518,90,86,176, 0.88 ,36,44,33,113, 0.57 ,42,79,46,167, 0.84 ,21,75,33,129, 0.65 ,44,64,23,131, 0.66 ,57,51,22,130, 0.65 ,846, 0.71 ,visual,1,Ask questions
ST-519,63,81,144, 0.72 ,28,75,51,154, 0.77 ,50,64,59,173, 0.87 ,20,33,30,83, 0.42 ,31,25,33,89, 0.45 ,22,45,32,99, 0.50 ,742, 0.62 ,auditory,4,Ask questions
ST-520,20,51,71, 0.36 ,40,31,37,108, 0.54 ,30,69,50,149, 0.75 ,51,27,21,99, 0.50 ,50,62,24,136, 0.68 ,47,71,34,152, 0.76 ,715, 0.60 ,kinesthetic,1,Study more
ST-521,29,98,127, 0.64 ,41,30,47,118, 0.59 ,24,22,54,100, 0.50 ,29,41,26,96, 0.48 ,33,77,22,132, 0.66 ,58,35,26,119, 0.60 ,692, 0.58 ,kinesthetic,3,Study more
ST-522,40,43,83, 0.42 ,32,45,50,127, 0.64 ,42,39,35,116, 0.58 ,29,53,28,110, 0.55 ,20,63,33,116, 0.58 ,26,63,22,111, 0.56 ,663, 0.55 ,kinesthetic,4,Join study group
ST-523,52,37,89, 0.45 ,32,59,38,129, 0.65 ,30,42,53,125, 0.63 ,33,20,22,75, 0.38 ,39,21,23,83, 0.42 ,51,43,37,131, 0.66 ,632, 0.53 ,auditory,3,Practice regularly
ST-524,46,60,106, 0.53 ,53,21,72,146, 0.73 ,35,60,21,116, 0.58 ,31,78,32,141, 0.71 ,31,24,35,90, 0.45 ,45,24,24,93, 0.47 ,692, 0.58 ,auditory,1,Ask questions
ST-525,87,70,157, 0.79 ,24,50,42,116, 0.58 ,42,74,26,142, 0.71 ,65,41,30,136, 0.68 ,21,53,31,105, 0.53 ,67,75,39,181, 0.91 ,837, 0.70 ,kinesthetic,1,Ask questions
ST-526,55,32,87, 0.44 ,28,55,39,122, 0.61 ,31,69,40,140, 0.70 ,56,60,30,146, 0.73 ,76,48,35,159, 0.80 ,50,30,23,103, 0.52 ,757, 0.63 ,auditory,2,Ask questions
ST-527,79,94,173, 0.87 ,43,77,46,166, 0.83 ,20,72,35,127, 0.64 ,39,74,32,145, 0.73 ,25,48,37,110, 0.55 ,40,58,20,118, 0.59 ,839, 0.70 ,auditory,1,Ask questions
ST-528,88,64,152, 0.76 ,38,47,48,133, 0.67 ,59,21,42,122, 0.61 ,54,29,27,110, 0.55 ,28,54,31,113, 0.57 ,55,34,29,118, 0.59 ,748, 0.62 ,kinesthetic,1,Ask questions
ST-529,20,22,42, 0.21 ,54,71,32,157, 0.79 ,57,64,79,200, 1.00 ,43,62,24,129, 0.65 ,60,37,22,119, 0.60 ,79,25,36,140, 0.70 ,787, 0.66 ,kinesthetic,3,Study more
ST-530,74,98,172, 0.86 ,25,53,58,136, 0.68 ,21,76,28,125, 0.63 ,45,48,30,123, 0.62 ,34,26,22,82, 0.41 ,67,44,34,145, 0.73 ,783, 0.65 ,kinesthetic,4,Study more
ST-531,39,28,67, 0.34 ,32,75,30,137, 0.69 ,26,23,73,122, 0.61 ,67,65,25,157, 0.79 ,35,70,26,131, 0.66 ,67,78,34,179, 0.90 ,793, 0.66 ,kinesthetic,3,Practice regularly
ST-532,97,65,162, 0.81 ,27,41,58,126, 0.63 ,25,30,51,106, 0.53 ,57,29,22,108, 0.54 ,38,60,28,126, 0.63 ,77,33,30,140, 0.70 ,768, 0.64 ,visual,5,Ask questions
ST-533,51,58,109, 0.55 ,56,39,48,143, 0.72 ,26,53,55,134, 0.67 ,72,53,36,161, 0.81 ,53,73,27,153, 0.77 ,62,54,25,141, 0.71 ,841, 0.70 ,auditory,4,Join study group
ST-534,58,66,124, 0.62 ,53,47,41,141, 0.71 ,42,53,58,153, 0.77 ,64,23,35,122, 0.61 ,56,22,23,101, 0.51 ,34,55,37,126, 0.63 ,767, 0.64 ,visual,2,Ask questions
ST-535,40,68,108, 0.54 ,42,60,68,170, 0.85 ,27,31,76,134, 0.67 ,70,77,27,174, 0.87 ,23,42,39,104, 0.52 ,36,56,22,114, 0.57 ,804, 0.67 ,kinesthetic,5,Study more
ST-536,49,20,69, 0.35 ,59,33,75,167, 0.84 ,48,43,30,121, 0.61 ,70,40,21,131, 0.66 ,25,55,22,102, 0.51 ,53,63,20,136, 0.68 ,726, 0.61 ,kinesthetic,1,Join study group
ST-537,54,68,122, 0.61 ,23,44,41,108, 0.54 ,28,34,79,141, 0.71 ,57,75,28,160, 0.80 ,49,25,26,100, 0.50 ,76,52,29,157, 0.79 ,788, 0.66 ,kinesthetic,4,Study more
ST-538,47,77,124, 0.62 ,29,45,54,128, 0.64 ,21,52,55,128, 0.64 ,65,36,32,133, 0.67 ,45,52,22,119, 0.60 ,57,51,38,146, 0.73 ,778, 0.65 ,visual,3,Practice regularly
ST-539,92,37,129, 0.65 ,29,22,48,99, 0.50 ,30,78,29,137, 0.69 ,24,43,21,88, 0.44 ,72,41,36,149, 0.75 ,75,25,34,134, 0.67 ,736, 0.61 ,visual,5,Ask questions
ST-540,84,43,127, 0.64 ,30,74,43,147, 0.74 ,31,34,63,128, 0.64 ,57,37,25,119, 0.60 ,67,49,30,146, 0.73 ,65,30,29,124, 0.62 ,791, 0.66 ,auditory,2,Practice regularly
ST-541,44,31,75, 0.38 ,39,38,21,98, 0.49 ,21,57,20,98, 0.49 ,36,38,33,107, 0.54 ,76,79,29,184, 0.92 ,46,22,30,98, 0.49 ,660, 0.55 ,visual,4,Ask questions
ST-542,71,96,167, 0.84 ,42,77,20,139, 0.70 ,41,40,20,101, 0.51 ,44,64,38,146, 0.73 ,56,68,35,159, 0.80 ,71,23,38,132, 0.66 ,844, 0.70 ,auditory,5,Ask questions
ST-543,84,73,157, 0.79 ,36,39,36,111, 0.56 ,26,68,53,147, 0.74 ,69,50,33,152, 0.76 ,35,35,35,105, 0.53 ,63,71,31,165, 0.83 ,837, 0.70 ,kinesthetic,3,Practice regularly
ST-544,74,90,164, 0.82 ,37,21,53,111, 0.56 ,27,29,60,116, 0.58 ,72,35,35,142, 0.71 ,28,27,26,81, 0.41 ,64,63,22,149, 0.75 ,763, 0.64 ,kinesthetic,5,Practice regularly
ST-545,73,29,102, 0.51 ,35,64,69,168, 0.84 ,23,32,56,111, 0.56 ,47,22,31,100, 0.50 ,39,71,38,148, 0.74 ,70,41,23,134, 0.67 ,763, 0.64 ,visual,3,Study more
ST-546,37,53,90, 0.45 ,54,28,39,121, 0.61 ,36,43,71,150, 0.75 ,58,48,34,140, 0.70 ,50,55,37,142, 0.71 ,47,38,39,124, 0.62 ,767, 0.64 ,visual,3,Ask questions
ST-547,94,62,156, 0.78 ,59,62,57,178, 0.89 ,45,44,73,162, 0.81 ,79,38,26,143, 0.72 ,42,41,32,115, 0.58 ,75,49,21,145, 0.73 ,899, 0.75 ,visual,1,Join study group
ST-548,70,50,120, 0.60 ,23,32,60,115, 0.58 ,21,44,20,85, 0.43 ,75,69,28,172, 0.86 ,52,30,25,107, 0.54 ,79,24,39,142, 0.71 ,741, 0.62 ,visual,2,Join study group
ST-549,33,34,67, 0.34 ,59,30,41,130, 0.65 ,39,60,62,161, 0.81 ,72,45,28,145, 0.73 ,23,27,35,85, 0.43 ,41,43,34,118, 0.59 ,706, 0.59 ,auditory,2,Join study group
ST-550,31,80,111, 0.56 ,45,55,20,120, 0.60 ,53,64,32,149, 0.75 ,69,49,34,152, 0.76 ,28,27,26,81, 0.41 ,74,23,35,132, 0.66 ,745, 0.62 ,kinesthetic,4,Practice regularly
ST-551,24,88,112, 0.56 ,50,55,73,178, 0.89 ,29,65,60,154, 0.77 ,30,23,29,82, 0.41 ,48,75,21,144, 0.72 ,22,23,21,66, 0.33 ,736, 0.61 ,kinesthetic,5,Study more
ST-552,66,32,98, 0.49 ,49,59,69,177, 0.89 ,51,48,69,168, 0.84 ,70,53,34,157, 0.79 ,63,54,33,150, 0.75 ,46,57,26,129, 0.65 ,879, 0.73 ,auditory,4,Practice regularly
ST-553,89,64,153, 0.77 ,35,56,35,126, 0.63 ,29,57,63,149, 0.75 ,30,69,22,121, 0.61 ,67,70,26,163, 0.82 ,79,48,26,153, 0.77 ,865, 0.72 ,visual,2,Study more
ST-554,95,30,125, 0.63 ,45,34,24,103, 0.52 ,52,21,62,135, 0.68 ,43,33,35,111, 0.56 ,57,32,38,127, 0.64 ,76,41,23,140, 0.70 ,741, 0.62 ,kinesthetic,5,Practice regularly
ST-555,24,40,64, 0.32 ,33,76,46,155, 0.78 ,28,43,53,124, 0.62 ,49,29,23,101, 0.51 ,66,36,28,130, 0.65 ,38,61,23,122, 0.61 ,696, 0.58 ,kinesthetic,5,Practice regularly
ST-556,61,46,107, 0.54 ,58,24,67,149, 0.75 ,51,22,67,140, 0.70 ,28,60,31,119, 0.60 ,58,49,35,142, 0.71 ,31,29,26,86, 0.43 ,743, 0.62 ,kinesthetic,1,Ask questions
ST-557,66,59,125, 0.63 ,29,59,24,112, 0.56 ,29,40,55,124, 0.62 ,73,65,36,174, 0.87 ,77,78,22,177, 0.89 ,49,34,27,110, 0.55 ,822, 0.69 ,kinesthetic,2,Practice regularly
ST-558,97,36,133, 0.67 ,52,44,33,129, 0.65 ,38,36,44,118, 0.59 ,79,30,36,145, 0.73 ,63,54,20,137, 0.69 ,54,77,21,152, 0.76 ,814, 0.68 ,auditory,4,Practice regularly
ST-559,96,77,173, 0.87 ,25,43,72,140, 0.70 ,34,44,20,98, 0.49 ,48,29,35,112, 0.56 ,61,52,26,139, 0.70 ,35,34,29,98, 0.49 ,760, 0.63 ,visual,1,Ask questions
ST-560,29,46,75, 0.38 ,43,37,29,109, 0.55 ,24,32,58,114, 0.57 ,34,49,36,119, 0.60 ,69,74,32,175, 0.88 ,31,50,22,103, 0.52 ,695, 0.58 ,kinesthetic,2,Practice regularly
ST-561,28,84,112, 0.56 ,53,69,71,193, 0.97 ,20,21,62,103, 0.52 ,66,50,21,137, 0.69 ,50,79,28,157, 0.79 ,48,27,31,106, 0.53 ,808, 0.67 ,auditory,1,Join study group
ST-562,31,68,99, 0.50 ,51,38,57,146, 0.73 ,32,56,61,149, 0.75 ,78,56,35,169, 0.85 ,71,56,32,159, 0.80 ,64,63,34,161, 0.81 ,883, 0.74 ,kinesthetic,5,Ask questions
ST-563,60,77,137, 0.69 ,30,38,45,113, 0.57 ,45,69,26,140, 0.70 ,34,75,35,144, 0.72 ,61,76,39,176, 0.88 ,57,26,24,107, 0.54 ,817, 0.68 ,kinesthetic,1,Ask questions
ST-564,34,34,68, 0.34 ,27,60,74,161, 0.81 ,49,38,76,163, 0.82 ,20,39,39,98, 0.49 ,36,44,26,106, 0.53 ,53,33,30,116, 0.58 ,712, 0.59 ,visual,2,Ask questions
ST-565,92,94,186, 0.93 ,48,22,53,123, 0.62 ,51,28,57,136, 0.68 ,65,36,33,134, 0.67 ,76,21,20,117, 0.59 ,49,60,28,137, 0.69 ,833, 0.69 ,auditory,5,Practice regularly
ST-566,97,46,143, 0.72 ,28,51,47,126, 0.63 ,38,44,63,145, 0.73 ,33,55,33,121, 0.61 ,65,44,20,129, 0.65 ,78,20,37,135, 0.68 ,799, 0.67 ,auditory,2,Study more
ST-567,98,46,144, 0.72 ,26,40,20,86, 0.43 ,22,57,46,125, 0.63 ,47,60,28,135, 0.68 ,45,57,34,136, 0.68 ,24,66,39,129, 0.65 ,755, 0.63 ,visual,2,Study more
ST-568,43,72,115, 0.58 ,20,55,46,121, 0.61 ,48,44,78,170, 0.85 ,34,53,37,124, 0.62 ,52,61,22,135, 0.68 ,43,50,20,113, 0.57 ,778, 0.65 ,visual,4,Join study group
ST-569,82,25,107, 0.54 ,44,36,77,157, 0.79 ,27,78,26,131, 0.66 ,39,41,35,115, 0.58 ,72,49,29,150, 0.75 ,71,42,24,137, 0.69 ,797, 0.66 ,kinesthetic,4,Join study group
ST-570,30,78,108, 0.54 ,56,25,35,116, 0.58 ,46,76,63,185, 0.93 ,27,33,34,94, 0.47 ,61,46,27,134, 0.67 ,23,38,24,85, 0.43 ,722, 0.60 ,visual,4,Study more
ST-571,84,81,165, 0.83 ,36,67,41,144, 0.72 ,36,60,32,128, 0.64 ,44,38,25,107, 0.54 ,33,41,21,95, 0.48 ,29,62,34,125, 0.63 ,764, 0.64 ,kinesthetic,4,Practice regularly
ST-572,20,96,116, 0.58 ,25,69,62,156, 0.78 ,51,79,78,208, 1.04 ,32,37,23,92, 0.46 ,30,49,29,108, 0.54 ,62,49,38,149, 0.75 ,829, 0.69 ,kinesthetic,4,Study more
ST-573,80,78,158, 0.79 ,38,39,44,121, 0.61 ,47,76,36,159, 0.80 ,46,28,38,112, 0.56 ,21,42,35,98, 0.49 ,63,72,35,170, 0.85 ,818, 0.68 ,auditory,1,Practice regularly
ST-574,62,42,104, 0.52 ,28,53,34,115, 0.58 ,53,74,70,197, 0.99 ,76,32,33,141, 0.71 ,50,40,22,112, 0.56 ,65,56,25,146, 0.73 ,815, 0.68 ,visual,3,Join study group
ST-575,97,49,146, 0.73 ,38,38,73,149, 0.75 ,48,53,50,151, 0.76 ,38,77,27,142, 0.71 ,33,43,30,106, 0.53 ,45,22,29,96, 0.48 ,790, 0.66 ,kinesthetic,2,Join study group
ST-576,67,65,132, 0.66 ,34,67,70,171, 0.86 ,51,63,61,175, 0.88 ,23,60,32,115, 0.58 ,22,31,36,89, 0.45 ,69,73,32,174, 0.87 ,856, 0.71 ,visual,3,Study more
ST-577,76,93,169, 0.85 ,43,25,26,94, 0.47 ,52,55,66,173, 0.87 ,44,25,31,100, 0.50 ,44,56,31,131, 0.66 ,78,46,26,150, 0.75 ,817, 0.68 ,visual,5,Join study group
ST-578,41,85,126, 0.63 ,50,72,24,146, 0.73 ,55,65,30,150, 0.75 ,41,46,31,118, 0.59 ,33,24,38,95, 0.48 ,30,23,30,83, 0.42 ,718, 0.60 ,auditory,5,Ask questions
ST-579,43,70,113, 0.57 ,27,72,45,144, 0.72 ,25,50,55,130, 0.65 ,62,62,25,149, 0.75 ,25,59,22,106, 0.53 ,53,53,26,132, 0.66 ,774, 0.65 ,auditory,4,Study more
ST-580,38,57,95, 0.48 ,45,48,42,135, 0.68 ,24,78,24,126, 0.63 ,45,78,27,150, 0.75 ,25,79,24,128, 0.64 ,59,34,35,128, 0.64 ,762, 0.64 ,visual,1,Study more
ST-581,78,90,168, 0.84 ,56,50,71,177, 0.89 ,25,29,72,126, 0.63 ,64,55,36,155, 0.78 ,57,20,33,110, 0.55 ,65,65,39,169, 0.85 ,905, 0.75 ,visual,1,Practice regularly
ST-582,88,72,160, 0.80 ,46,40,22,108, 0.54 ,39,27,52,118, 0.59 ,67,48,33,148, 0.74 ,35,29,33,97, 0.49 ,47,55,25,127, 0.64 ,758, 0.63 ,visual,3,Join study group
ST-583,29,49,78, 0.39 ,40,25,77,142, 0.71 ,33,25,28,86, 0.43 ,33,55,33,121, 0.61 ,45,31,36,112, 0.56 ,62,62,33,157, 0.79 ,696, 0.58 ,auditory,2,Study more
ST-584,72,44,116, 0.58 ,21,50,72,143, 0.72 ,32,67,20,119, 0.60 ,26,66,25,117, 0.59 ,55,28,26,109, 0.55 ,33,76,33,142, 0.71 ,746, 0.62 ,auditory,4,Practice regularly
ST-585,52,73,125, 0.63 ,49,32,78,159, 0.80 ,31,49,31,111, 0.56 ,30,78,27,135, 0.68 ,20,78,29,127, 0.64 ,44,42,24,110, 0.55 ,767, 0.64 ,auditory,3,Practice regularly
ST-586,88,65,153, 0.77 ,41,64,47,152, 0.76 ,58,76,51,185, 0.93 ,65,72,26,163, 0.82 ,59,20,32,111, 0.56 ,35,54,39,128, 0.64 ,892, 0.74 ,auditory,4,Study more
ST-587,22,86,108, 0.54 ,22,46,75,143, 0.72 ,52,73,34,159, 0.80 ,63,60,39,162, 0.81 ,63,25,24,112, 0.56 ,34,63,36,133, 0.67 ,817, 0.68 ,kinesthetic,4,Ask questions
ST-588,75,47,122, 0.61 ,30,76,39,145, 0.73 ,30,21,41,92, 0.46 ,63,57,24,144, 0.72 ,63,23,20,106, 0.53 ,59,23,32,114, 0.57 ,723, 0.60 ,auditory,4,Study more
ST-589,50,76,126, 0.63 ,53,31,74,158, 0.79 ,28,53,21,102, 0.51 ,70,56,22,148, 0.74 ,21,45,21,87, 0.44 ,46,22,29,97, 0.49 ,718, 0.60 ,kinesthetic,5,Join study group
ST-590,57,26,83, 0.42 ,24,28,71,123, 0.62 ,20,43,76,139, 0.70 ,26,62,23,111, 0.56 ,61,29,30,120, 0.60 ,44,24,25,93, 0.47 ,669, 0.56 ,auditory,1,Practice regularly
ST-591,98,39,137, 0.69 ,28,33,72,133, 0.67 ,50,32,44,126, 0.63 ,72,56,28,156, 0.78 ,54,36,35,125, 0.63 ,42,68,37,147, 0.74 ,824, 0.69 ,visual,4,Ask questions
ST-592,26,76,102, 0.51 ,47,35,21,103, 0.52 ,58,66,57,181, 0.91 ,56,61,28,145, 0.73 ,65,76,23,164, 0.82 ,48,59,32,139, 0.70 ,834, 0.70 ,kinesthetic,5,Join study group
ST-593,20,63,83, 0.42 ,58,58,48,164, 0.82 ,59,49,72,180, 0.90 ,53,36,24,113, 0.57 ,58,57,27,142, 0.71 ,38,20,36,94, 0.47 ,776, 0.65 ,auditory,2,Practice regularly
ST-594,71,43,114, 0.57 ,41,70,34,145, 0.73 ,50,45,70,165, 0.83 ,60,38,27,125, 0.63 ,47,57,20,124, 0.62 ,73,37,28,138, 0.69 ,811, 0.68 ,visual,5,Practice regularly
ST-595,94,45,139, 0.70 ,53,28,65,146, 0.73 ,38,35,74,147, 0.74 ,66,71,37,174, 0.87 ,48,32,22,102, 0.51 ,32,52,37,121, 0.61 ,829, 0.69 ,kinesthetic,1,Study more
ST-596,84,88,172, 0.86 ,43,49,55,147, 0.74 ,50,37,23,110, 0.55 ,41,57,31,129, 0.65 ,27,49,23,99, 0.50 ,37,33,33,103, 0.52 ,760, 0.63 ,visual,3,Join study group
ST-597,61,32,93, 0.47 ,51,38,45,134, 0.67 ,26,27,40,93, 0.47 ,57,77,21,155, 0.78 ,29,67,21,117, 0.59 ,47,31,32,110, 0.55 ,702, 0.59 ,visual,3,Study more
ST-598,51,74,125, 0.63 ,57,76,74,207, 1.04 ,21,30,53,104, 0.52 ,58,74,32,164, 0.82 ,44,78,33,155, 0.78 ,59,49,24,132, 0.66 ,887, 0.74 ,kinesthetic,2,Ask questions
ST-599,44,58,102, 0.51 ,29,27,66,122, 0.61 ,40,23,43,106, 0.53 ,45,61,27,133, 0.67 ,24,62,21,107, 0.54 ,53,74,36,163, 0.82 ,733, 0.61 ,kinesthetic,1,Join study group
ST-600,34,72,106, 0.53 ,22,32,42,96, 0.48 ,59,79,38,176, 0.88 ,73,25,22,120, 0.60 ,47,70,39,156, 0.78 ,50,72,33,155, 0.78 ,809, 0.67 ,auditory,3,Join study group
ST-601,53,91,144, 0.72 ,26,41,24,91, 0.46 ,41,22,35,98, 0.49 ,34,41,38,113, 0.57 ,49,34,22,105, 0.53 ,70,67,36,173, 0.87 ,724, 0.60 ,visual,2,Join study group
ST-602,55,46,101, 0.51 ,26,32,47,105, 0.53 ,45,54,46,145, 0.73 ,28,46,35,109, 0.55 ,59,54,34,147, 0.74 ,64,68,21,153, 0.77 ,760, 0.63 ,kinesthetic,2,Ask questions
ST-603,55,28,83, 0.42 ,25,75,78,178, 0.89 ,53,22,56,131, 0.66 ,52,79,34,165, 0.83 ,35,56,33,124, 0.62 ,41,37,36,114, 0.57 ,795, 0.66 ,auditory,2,Practice regularly
ST-604,51,41,92, 0.46 ,54,53,52,159, 0.80 ,44,43,51,138, 0.69 ,24,26,23,73, 0.37 ,58,64,34,156, 0.78 ,26,65,33,124, 0.62 ,742, 0.62 ,visual,2,Practice regularly
ST-605,29,35,64, 0.32 ,34,49,47,130, 0.65 ,58,42,58,158, 0.79 ,59,65,38,162, 0.81 ,72,59,21,152, 0.76 ,58,42,28,128, 0.64 ,794, 0.66 ,auditory,3,Study more
ST-606,86,31,117, 0.59 ,53,61,60,174, 0.87 ,26,20,42,88, 0.44 ,44,67,29,140, 0.70 ,52,37,35,124, 0.62 ,25,36,24,85, 0.43 ,728, 0.61 ,auditory,5,Ask questions
ST-607,67,24,91, 0.46 ,20,79,24,123, 0.62 ,25,27,74,126, 0.63 ,52,36,32,120, 0.60 ,24,56,35,115, 0.58 ,66,77,38,181, 0.91 ,756, 0.63 ,kinesthetic,2,Practice regularly
ST-608,39,37,76, 0.38 ,54,42,20,116, 0.58 ,49,46,48,143, 0.72 ,59,61,39,159, 0.80 ,56,23,21,100, 0.50 ,60,61,33,154, 0.77 ,748, 0.62 ,visual,3,Practice regularly
ST-609,81,34,115, 0.58 ,32,24,73,129, 0.65 ,24,21,65,110, 0.55 ,40,65,30,135, 0.68 ,71,34,22,127, 0.64 ,38,64,21,123, 0.62 ,739, 0.62 ,kinesthetic,1,Practice regularly
ST-610,73,22,95, 0.48 ,44,63,46,153, 0.77 ,51,43,56,150, 0.75 ,71,41,32,144, 0.72 ,64,43,35,142, 0.71 ,39,21,23,83, 0.42 ,767, 0.64 ,visual,2,Ask questions
ST-611,59,40,99, 0.50 ,33,38,44,115, 0.58 ,58,54,52,164, 0.82 ,52,25,36,113, 0.57 ,23,60,37,120, 0.60 ,72,35,37,144, 0.72 ,755, 0.63 ,kinesthetic,2,Practice regularly
ST-612,94,64,158, 0.79 ,51,27,76,154, 0.77 ,58,35,55,148, 0.74 ,30,65,32,127, 0.64 ,68,61,31,160, 0.80 ,43,60,37,140, 0.70 ,887, 0.74 ,visual,1,Join study group
ST-613,30,38,68, 0.34 ,55,63,78,196, 0.98 ,32,44,40,116, 0.58 ,59,59,28,146, 0.73 ,39,76,33,148, 0.74 ,34,24,25,83, 0.42 ,757, 0.63 ,kinesthetic,3,Study more
ST-614,77,66,143, 0.72 ,26,64,57,147, 0.74 ,43,24,43,110, 0.55 ,68,49,35,152, 0.76 ,64,75,39,178, 0.89 ,65,77,22,164, 0.82 ,894, 0.75 ,kinesthetic,5,Join study group
ST-615,39,52,91, 0.46 ,49,30,22,101, 0.51 ,52,47,51,150, 0.75 ,52,68,29,149, 0.75 ,62,49,33,144, 0.72 ,43,68,38,149, 0.75 ,784, 0.65 ,auditory,2,Practice regularly
ST-616,43,21,64, 0.32 ,25,50,58,133, 0.67 ,29,30,71,130, 0.65 ,74,35,24,133, 0.67 ,50,39,20,109, 0.55 ,46,48,35,129, 0.65 ,698, 0.58 ,auditory,1,Ask questions
ST-617,57,45,102, 0.51 ,29,62,49,140, 0.70 ,21,66,64,151, 0.76 ,66,42,25,133, 0.67 ,32,62,38,132, 0.66 ,55,69,34,158, 0.79 ,816, 0.68 ,visual,1,Ask questions
ST-618,60,55,115, 0.58 ,20,61,52,133, 0.67 ,58,56,62,176, 0.88 ,77,48,30,155, 0.78 ,78,27,22,127, 0.64 ,74,68,22,164, 0.82 ,870, 0.73 ,kinesthetic,2,Ask questions
ST-619,37,95,132, 0.66 ,55,41,31,127, 0.64 ,30,29,74,133, 0.67 ,57,21,36,114, 0.57 ,59,26,21,106, 0.53 ,70,24,35,129, 0.65 ,741, 0.62 ,visual,1,Study more
ST-620,64,88,152, 0.76 ,32,45,45,122, 0.61 ,31,30,49,110, 0.55 ,69,33,38,140, 0.70 ,54,26,33,113, 0.57 ,53,79,33,165, 0.83 ,802, 0.67 ,kinesthetic,3,Study more
ST-621,97,67,164, 0.82 ,42,69,51,162, 0.81 ,37,76,63,176, 0.88 ,33,37,30,100, 0.50 ,25,38,39,102, 0.51 ,53,64,26,143, 0.72 ,847, 0.71 ,auditory,4,Practice regularly
ST-622,35,83,118, 0.59 ,53,70,34,157, 0.79 ,21,69,30,120, 0.60 ,37,71,37,145, 0.73 ,60,68,21,149, 0.75 ,56,68,37,161, 0.81 ,850, 0.71 ,visual,2,Study more
ST-623,75,69,144, 0.72 ,49,23,52,124, 0.62 ,47,43,44,134, 0.67 ,52,23,22,97, 0.49 ,72,41,36,149, 0.75 ,26,48,32,106, 0.53 ,754, 0.63 ,auditory,3,Study more
ST-624,85,89,174, 0.87 ,45,78,72,195, 0.98 ,23,38,78,139, 0.70 ,76,63,31,170, 0.85 ,21,31,34,86, 0.43 ,72,70,34,176, 0.88 ,940, 0.78 ,kinesthetic,5,Study more
ST-625,30,38,68, 0.34 ,53,44,26,123, 0.62 ,35,59,56,150, 0.75 ,52,78,22,152, 0.76 ,52,32,23,107, 0.54 ,76,25,37,138, 0.69 ,738, 0.62 ,kinesthetic,4,Practice regularly
ST-626,93,35,128, 0.64 ,40,66,59,165, 0.83 ,31,65,39,135, 0.68 ,38,36,39,113, 0.57 ,45,56,35,136, 0.68 ,35,77,22,134, 0.67 ,811, 0.68 ,auditory,5,Practice regularly
ST-627,43,67,110, 0.55 ,20,79,50,149, 0.75 ,36,59,31,126, 0.63 ,31,41,21,93, 0.47 ,66,43,38,147, 0.74 ,52,25,20,97, 0.49 ,722, 0.60 ,visual,3,Join study group
ST-628,50,48,98, 0.49 ,38,71,57,166, 0.83 ,55,25,47,127, 0.64 ,44,64,20,128, 0.64 ,71,38,34,143, 0.72 ,26,64,20,110, 0.55 ,772, 0.64 ,kinesthetic,3,Ask questions
ST-629,57,43,100, 0.50 ,32,68,79,179, 0.90 ,36,24,45,105, 0.53 ,65,44,36,145, 0.73 ,62,31,29,122, 0.61 ,58,62,23,143, 0.72 ,794, 0.66 ,auditory,4,Practice regularly
ST-630,45,33,78, 0.39 ,40,44,32,116, 0.58 ,40,56,75,171, 0.86 ,33,30,28,91, 0.46 ,42,76,32,150, 0.75 ,54,71,33,158, 0.79 ,764, 0.64 ,visual,1,Ask questions
ST-631,51,97,148, 0.74 ,32,33,27,92, 0.46 ,50,38,65,153, 0.77 ,77,69,25,171, 0.86 ,49,33,27,109, 0.55 ,30,38,31,99, 0.50 ,772, 0.64 ,auditory,4,Join study group
ST-632,73,31,104, 0.52 ,43,56,74,173, 0.87 ,55,67,48,170, 0.85 ,48,31,22,101, 0.51 ,22,68,24,114, 0.57 ,60,26,21,107, 0.54 ,769, 0.64 ,kinesthetic,2,Study more
ST-633,49,96,145, 0.73 ,35,21,35,91, 0.46 ,40,33,77,150, 0.75 ,36,59,38,133, 0.67 ,29,56,23,108, 0.54 ,29,21,22,72, 0.36 ,699, 0.58 ,kinesthetic,2,Ask questions
ST-634,36,94,130, 0.65 ,23,31,60,114, 0.57 ,26,26,26,78, 0.39 ,68,68,23,159, 0.80 ,21,65,20,106, 0.53 ,43,77,33,153, 0.77 ,740, 0.62 ,visual,4,Study more
ST-635,20,25,45, 0.23 ,33,75,64,172, 0.86 ,43,72,26,141, 0.71 ,39,36,24,99, 0.50 ,37,28,38,103, 0.52 ,38,37,37,112, 0.56 ,672, 0.56 ,kinesthetic,1,Join study group
ST-636,89,96,185, 0.93 ,36,67,61,164, 0.82 ,57,36,24,117, 0.59 ,65,58,37,160, 0.80 ,48,68,27,143, 0.72 ,60,57,29,146, 0.73 ,915, 0.76 ,visual,4,Ask questions
ST-637,34,30,64, 0.32 ,36,43,24,103, 0.52 ,51,31,68,150, 0.75 ,21,68,20,109, 0.55 ,41,37,35,113, 0.57 ,37,78,26,141, 0.71 ,680, 0.57 ,auditory,2,Join study group
ST-638,38,61,99, 0.50 ,29,24,77,130, 0.65 ,49,57,60,166, 0.83 ,67,64,31,162, 0.81 ,39,25,30,94, 0.47 ,58,59,26,143, 0.72 ,794, 0.66 ,visual,2,Ask questions
ST-639,28,75,103, 0.52 ,48,74,69,191, 0.96 ,28,32,61,121, 0.61 ,46,79,33,158, 0.79 ,43,60,37,140, 0.70 ,26,55,35,116, 0.58 ,829, 0.69 ,auditory,2,Study more
ST-640,86,47,133, 0.67 ,28,63,46,137, 0.69 ,43,65,47,155, 0.78 ,35,69,30,134, 0.67 ,70,34,28,132, 0.66 ,26,33,20,79, 0.40 ,770, 0.64 ,auditory,2,Practice regularly
ST-641,50,82,132, 0.66 ,39,48,74,161, 0.81 ,35,34,35,104, 0.52 ,62,66,25,153, 0.77 ,63,34,25,122, 0.61 ,45,49,38,132, 0.66 ,804, 0.67 ,auditory,1,Join study group
ST-642,40,71,111, 0.56 ,36,29,44,109, 0.55 ,21,42,60,123, 0.62 ,74,29,34,137, 0.69 ,63,48,38,149, 0.75 ,39,52,34,125, 0.63 ,754, 0.63 ,visual,4,Ask questions
ST-643,60,69,129, 0.65 ,34,75,21,130, 0.65 ,33,74,37,144, 0.72 ,75,42,21,138, 0.69 ,56,51,28,135, 0.68 ,61,58,23,142, 0.71 ,818, 0.68 ,auditory,2,Practice regularly
ST-644,68,77,145, 0.73 ,56,48,79,183, 0.92 ,49,62,68,179, 0.90 ,64,72,20,156, 0.78 ,32,30,29,91, 0.46 ,39,39,36,114, 0.57 ,868, 0.72 ,kinesthetic,4,Practice regularly
ST-645,57,61,118, 0.59 ,30,57,46,133, 0.67 ,36,46,22,104, 0.52 ,26,31,22,79, 0.40 ,67,41,27,135, 0.68 ,28,50,21,99, 0.50 ,668, 0.56 ,visual,5,Practice regularly
ST-646,51,30,81, 0.41 ,30,77,21,128, 0.64 ,59,62,35,156, 0.78 ,34,46,30,110, 0.55 ,27,45,30,102, 0.51 ,27,64,36,127, 0.64 ,704, 0.59 ,kinesthetic,2,Ask questions
ST-647,46,81,127, 0.64 ,21,54,39,114, 0.57 ,22,49,74,145, 0.73 ,54,56,35,145, 0.73 ,74,64,30,168, 0.84 ,45,29,32,106, 0.53 ,805, 0.67 ,kinesthetic,3,Practice regularly
ST-648,32,50,82, 0.41 ,26,73,20,119, 0.60 ,49,35,38,122, 0.61 ,69,47,23,139, 0.70 ,72,28,38,138, 0.69 ,65,68,38,171, 0.86 ,771, 0.64 ,visual,3,Study more
ST-649,33,80,113, 0.57 ,46,56,43,145, 0.73 ,24,51,70,145, 0.73 ,34,29,27,90, 0.45 ,26,33,28,87, 0.44 ,44,20,29,93, 0.47 ,673, 0.56 ,auditory,1,Practice regularly
ST-650,46,85,131, 0.66 ,53,34,44,131, 0.66 ,51,59,26,136, 0.68 ,59,73,39,171, 0.86 ,49,51,23,123, 0.62 ,59,56,21,136, 0.68 ,828, 0.69 ,auditory,5,Ask questions
ST-651,39,32,71, 0.36 ,57,21,55,133, 0.67 ,40,77,31,148, 0.74 ,57,46,30,133, 0.67 ,79,34,27,140, 0.70 ,61,40,27,128, 0.64 ,753, 0.63 ,auditory,5,Join study group
ST-652,72,25,97, 0.49 ,27,69,23,119, 0.60 ,35,35,50,120, 0.60 ,74,75,29,178, 0.89 ,53,79,35,167, 0.84 ,72,27,29,128, 0.64 ,809, 0.67 ,auditory,2,Ask questions
ST-653,37,79,116, 0.58 ,46,43,42,131, 0.66 ,28,32,44,104, 0.52 ,50,28,33,111, 0.56 ,65,69,30,164, 0.82 ,70,25,27,122, 0.61 ,748, 0.62 ,kinesthetic,1,Practice regularly
ST-654,42,95,137, 0.69 ,59,21,58,138, 0.69 ,36,32,54,122, 0.61 ,46,78,22,146, 0.73 ,31,72,31,134, 0.67 ,67,23,27,117, 0.59 ,794, 0.66 ,visual,3,Practice regularly
ST-655,80,51,131, 0.66 ,49,61,74,184, 0.92 ,55,54,37,146, 0.73 ,31,79,27,137, 0.69 ,35,26,34,95, 0.48 ,35,26,33,94, 0.47 ,787, 0.66 ,auditory,3,Ask questions
ST-656,68,56,124, 0.62 ,26,28,65,119, 0.60 ,42,63,76,181, 0.91 ,26,78,26,130, 0.65 ,69,62,29,160, 0.80 ,20,53,20,93, 0.47 ,807, 0.67 ,auditory,1,Practice regularly
ST-657,69,43,112, 0.56 ,37,24,23,84, 0.42 ,24,72,47,143, 0.72 ,33,64,21,118, 0.59 ,50,54,36,140, 0.70 ,67,51,25,143, 0.72 ,740, 0.62 ,kinesthetic,5,Ask questions
ST-658,77,84,161, 0.81 ,21,60,45,126, 0.63 ,52,68,54,174, 0.87 ,53,22,26,101, 0.51 ,35,28,33,96, 0.48 ,44,55,30,129, 0.65 ,787, 0.66 ,visual,1,Join study group
ST-659,47,49,96, 0.48 ,43,53,71,167, 0.84 ,49,48,54,151, 0.76 ,45,22,34,101, 0.51 ,42,75,31,148, 0.74 ,43,29,30,102, 0.51 ,765, 0.64 ,kinesthetic,4,Ask questions
ST-660,66,85,151, 0.76 ,22,62,21,105, 0.53 ,41,41,75,157, 0.79 ,52,69,31,152, 0.76 ,67,35,27,129, 0.65 ,62,48,38,148, 0.74 ,842, 0.70 ,kinesthetic,2,Study more
ST-661,84,40,124, 0.62 ,49,60,47,156, 0.78 ,21,20,26,67, 0.34 ,47,60,36,143, 0.72 ,70,41,38,149, 0.75 ,75,34,38,147, 0.74 ,786, 0.66 ,kinesthetic,3,Ask questions
ST-662,96,91,187, 0.94 ,30,58,25,113, 0.57 ,27,32,41,100, 0.50 ,24,33,31,88, 0.44 ,55,74,31,160, 0.80 ,53,38,25,116, 0.58 ,764, 0.64 ,kinesthetic,4,Ask questions
ST-663,93,39,132, 0.66 ,36,60,25,121, 0.61 ,27,24,78,129, 0.65 ,29,40,31,100, 0.50 ,32,69,23,124, 0.62 ,79,56,34,169, 0.85 ,775, 0.65 ,auditory,4,Join study group
ST-664,71,23,94, 0.47 ,39,42,26,107, 0.54 ,37,37,62,136, 0.68 ,71,31,34,136, 0.68 ,66,44,22,132, 0.66 ,33,48,30,111, 0.56 ,716, 0.60 ,visual,4,Ask questions
ST-665,49,89,138, 0.69 ,20,30,58,108, 0.54 ,55,26,51,132, 0.66 ,43,56,33,132, 0.66 ,55,58,33,146, 0.73 ,45,42,35,122, 0.61 ,778, 0.65 ,visual,1,Join study group
ST-666,61,65,126, 0.63 ,25,69,57,151, 0.76 ,34,75,73,182, 0.91 ,73,20,39,132, 0.66 ,53,61,22,136, 0.68 ,20,20,22,62, 0.31 ,789, 0.66 ,auditory,5,Ask questions
ST-667,37,38,75, 0.38 ,39,24,66,129, 0.65 ,22,31,66,119, 0.60 ,72,37,28,137, 0.69 ,32,28,39,99, 0.50 ,75,59,25,159, 0.80 ,718, 0.60 ,visual,2,Study more
ST-668,66,57,123, 0.62 ,23,59,21,103, 0.52 ,46,43,21,110, 0.55 ,76,72,31,179, 0.90 ,77,74,20,171, 0.86 ,52,75,37,164, 0.82 ,850, 0.71 ,auditory,1,Study more
ST-669,99,37,136, 0.68 ,56,64,29,149, 0.75 ,36,70,71,177, 0.89 ,54,60,37,151, 0.76 ,29,69,35,133, 0.67 ,73,23,39,135, 0.68 ,881, 0.73 ,auditory,5,Ask questions
ST-670,84,95,179, 0.90 ,42,53,22,117, 0.59 ,57,75,73,205, 1.03 ,69,29,37,135, 0.68 ,68,79,32,179, 0.90 ,35,75,30,140, 0.70 ,955, 0.80 ,kinesthetic,1,Practice regularly
ST-671,77,94,171, 0.86 ,22,31,66,119, 0.60 ,40,52,79,171, 0.86 ,24,27,24,75, 0.38 ,50,41,29,120, 0.60 ,21,61,20,102, 0.51 ,758, 0.63 ,visual,5,Ask questions
ST-672,70,69,139, 0.70 ,33,33,34,100, 0.50 ,48,70,69,187, 0.94 ,64,79,33,176, 0.88 ,31,51,28,110, 0.55 ,77,54,20,151, 0.76 ,863, 0.72 ,auditory,1,Ask questions
ST-673,83,45,128, 0.64 ,25,36,60,121, 0.61 ,21,28,48,97, 0.49 ,31,71,25,127, 0.64 ,66,66,37,169, 0.85 ,50,56,22,128, 0.64 ,770, 0.64 ,kinesthetic,1,Practice regularly
ST-674,71,46,117, 0.59 ,50,33,20,103, 0.52 ,40,30,58,128, 0.64 ,77,20,37,134, 0.67 ,21,58,35,114, 0.57 ,22,36,30,88, 0.44 ,684, 0.57 ,auditory,5,Study more
ST-675,36,50,86, 0.43 ,46,22,22,90, 0.45 ,24,22,62,108, 0.54 ,23,48,27,98, 0.49 ,65,73,39,177, 0.89 ,39,78,28,145, 0.73 ,704, 0.59 ,auditory,3,Practice regularly
ST-676,60,97,157, 0.79 ,24,38,37,99, 0.50 ,31,34,66,131, 0.66 ,45,37,37,119, 0.60 ,20,79,38,137, 0.69 ,34,75,30,139, 0.70 ,782, 0.65 ,kinesthetic,2,Practice regularly
ST-677,64,36,100, 0.50 ,47,56,31,134, 0.67 ,27,45,40,112, 0.56 ,72,53,32,157, 0.79 ,33,31,33,97, 0.49 ,44,27,21,92, 0.46 ,692, 0.58 ,kinesthetic,5,Ask questions
ST-678,22,35,57, 0.29 ,49,23,66,138, 0.69 ,31,63,78,172, 0.86 ,76,25,38,139, 0.70 ,70,45,27,142, 0.71 ,38,31,39,108, 0.54 ,756, 0.63 ,kinesthetic,2,Join study group
ST-679,74,88,162, 0.81 ,58,44,76,178, 0.89 ,47,70,64,181, 0.91 ,26,32,24,82, 0.41 ,54,46,26,126, 0.63 ,32,27,24,83, 0.42 ,812, 0.68 ,visual,3,Join study group
ST-680,20,62,82, 0.41 ,23,23,34,80, 0.40 ,52,75,25,152, 0.76 ,46,58,21,125, 0.63 ,49,53,34,136, 0.68 ,32,40,31,103, 0.52 ,678, 0.57 ,kinesthetic,1,Study more
ST-681,34,91,125, 0.63 ,36,23,74,133, 0.67 ,57,20,67,144, 0.72 ,23,54,37,114, 0.57 ,71,77,39,187, 0.94 ,66,53,33,152, 0.76 ,855, 0.71 ,auditory,1,Practice regularly
ST-682,37,76,113, 0.57 ,50,39,42,131, 0.66 ,48,57,53,158, 0.79 ,66,46,39,151, 0.76 ,51,76,31,158, 0.79 ,66,52,23,141, 0.71 ,852, 0.71 ,visual,1,Study more
ST-683,34,40,74, 0.37 ,41,61,73,175, 0.88 ,23,20,54,97, 0.49 ,51,50,22,123, 0.62 ,39,30,36,105, 0.53 ,33,57,37,127, 0.64 ,701, 0.58 ,visual,2,Study more
ST-684,94,70,164, 0.82 ,41,79,61,181, 0.91 ,28,53,43,124, 0.62 ,53,41,27,121, 0.61 ,51,55,33,139, 0.70 ,79,22,26,127, 0.64 ,856, 0.71 ,auditory,1,Ask questions
ST-685,97,42,139, 0.70 ,50,69,60,179, 0.90 ,30,71,25,126, 0.63 ,26,75,26,127, 0.64 ,77,70,27,174, 0.87 ,62,68,20,150, 0.75 ,895, 0.75 ,kinesthetic,2,Join study group
ST-686,25,48,73, 0.37 ,56,67,65,188, 0.94 ,30,60,65,155, 0.78 ,47,60,37,144, 0.72 ,21,31,32,84, 0.42 ,36,59,25,120, 0.60 ,764, 0.64 ,auditory,5,Join study group
ST-687,96,73,169, 0.85 ,53,73,38,164, 0.82 ,27,43,53,123, 0.62 ,53,59,25,137, 0.69 ,59,71,21,151, 0.76 ,46,38,23,107, 0.54 ,851, 0.71 ,visual,5,Ask questions
ST-688,28,21,49, 0.25 ,41,55,68,164, 0.82 ,52,63,65,180, 0.90 ,20,53,21,94, 0.47 ,66,75,26,167, 0.84 ,32,24,20,76, 0.38 ,730, 0.61 ,auditory,4,Ask questions
ST-689,66,46,112, 0.56 ,31,52,71,154, 0.77 ,38,47,47,132, 0.66 ,49,25,32,106, 0.53 ,46,55,31,132, 0.66 ,55,43,35,133, 0.67 ,769, 0.64 ,auditory,4,Practice regularly
ST-690,27,89,116, 0.58 ,25,46,79,150, 0.75 ,45,73,44,162, 0.81 ,54,40,31,125, 0.63 ,21,35,25,81, 0.41 ,56,43,34,133, 0.67 ,767, 0.64 ,kinesthetic,4,Practice regularly
ST-691,36,37,73, 0.37 ,54,69,66,189, 0.95 ,33,57,27,117, 0.59 ,54,74,34,162, 0.81 ,61,77,38,176, 0.88 ,55,32,36,123, 0.62 ,840, 0.70 ,kinesthetic,3,Ask questions
ST-692,40,96,136, 0.68 ,29,40,70,139, 0.70 ,21,50,78,149, 0.75 ,27,43,33,103, 0.52 ,30,29,39,98, 0.49 ,72,55,30,157, 0.79 ,782, 0.65 ,auditory,2,Study more
ST-693,48,84,132, 0.66 ,32,52,44,128, 0.64 ,28,39,65,132, 0.66 ,31,65,32,128, 0.64 ,49,21,39,109, 0.55 ,55,31,36,122, 0.61 ,751, 0.63 ,auditory,5,Practice regularly
ST-694,62,36,98, 0.49 ,52,47,28,127, 0.64 ,35,42,36,113, 0.57 ,43,50,26,119, 0.60 ,75,38,27,140, 0.70 ,20,47,29,96, 0.48 ,693, 0.58 ,visual,1,Ask questions
ST-695,67,95,162, 0.81 ,23,35,54,112, 0.56 ,50,43,59,152, 0.76 ,62,62,27,151, 0.76 ,62,47,37,146, 0.73 ,21,58,25,104, 0.52 ,827, 0.69 ,visual,5,Practice regularly
ST-696,26,86,112, 0.56 ,49,77,20,146, 0.73 ,34,72,73,179, 0.90 ,64,22,37,123, 0.62 ,48,27,27,102, 0.51 ,50,52,37,139, 0.70 ,801, 0.67 ,visual,1,Join study group
ST-697,90,47,137, 0.69 ,29,24,49,102, 0.51 ,20,50,50,120, 0.60 ,55,70,37,162, 0.81 ,55,54,32,141, 0.71 ,38,48,38,124, 0.62 ,786, 0.66 ,auditory,2,Practice regularly
ST-698,77,65,142, 0.71 ,36,58,49,143, 0.72 ,25,73,64,162, 0.81 ,37,36,22,95, 0.48 ,57,47,21,125, 0.63 ,73,69,39,181, 0.91 ,848, 0.71 ,auditory,1,Practice regularly
ST-699,50,57,107, 0.54 ,39,51,44,134, 0.67 ,38,54,26,118, 0.59 ,46,77,26,149, 0.75 ,20,72,37,129, 0.65 ,29,72,23,124, 0.62 ,761, 0.63 ,auditory,3,Study more
ST-700,47,55,102, 0.51 ,54,20,53,127, 0.64 ,53,42,64,159, 0.80 ,71,30,22,123, 0.62 ,32,39,38,109, 0.55 ,26,55,26,107, 0.54 ,727, 0.61 ,kinesthetic,4,Study more
ST-701,48,43,91, 0.46 ,28,50,71,149, 0.75 ,56,54,71,181, 0.91 ,64,65,39,168, 0.84 ,60,67,36,163, 0.82 ,75,41,28,144, 0.72 ,896, 0.75 ,visual,3,Study more
ST-702,68,26,94, 0.47 ,50,34,62,146, 0.73 ,42,63,73,178, 0.89 ,23,55,23,101, 0.51 ,70,20,22,112, 0.56 ,46,21,34,101, 0.51 ,732, 0.61 ,visual,3,Ask questions
ST-703,62,47,109, 0.55 ,55,43,46,144, 0.72 ,35,38,64,137, 0.69 ,53,70,24,147, 0.74 ,25,76,37,138, 0.69 ,56,26,37,119, 0.60 ,794, 0.66 ,auditory,1,Practice regularly
ST-704,83,69,152, 0.76 ,45,30,55,130, 0.65 ,27,71,58,156, 0.78 ,27,52,36,115, 0.58 ,34,61,27,122, 0.61 ,30,28,30,88, 0.44 ,763, 0.64 ,auditory,3,Practice regularly
ST-705,37,79,116, 0.58 ,25,49,29,103, 0.52 ,59,26,23,108, 0.54 ,55,43,37,135, 0.68 ,39,58,27,124, 0.62 ,79,44,35,158, 0.79 ,744, 0.62 ,kinesthetic,3,Study more
ST-706,80,76,156, 0.78 ,47,43,36,126, 0.63 ,25,36,27,88, 0.44 ,29,34,22,85, 0.43 ,71,64,34,169, 0.85 ,69,46,28,143, 0.72 ,767, 0.64 ,visual,5,Study more
ST-707,54,77,131, 0.66 ,52,45,35,132, 0.66 ,20,74,68,162, 0.81 ,61,70,36,167, 0.84 ,23,77,39,139, 0.70 ,72,48,38,158, 0.79 ,889, 0.74 ,visual,5,Ask questions
ST-708,58,52,110, 0.55 ,48,40,77,165, 0.83 ,50,62,24,136, 0.68 ,34,53,25,112, 0.56 ,40,22,29,91, 0.46 ,41,67,20,128, 0.64 ,742, 0.62 ,auditory,3,Join study group
ST-709,24,83,107, 0.54 ,39,44,58,141, 0.71 ,52,55,57,164, 0.82 ,25,53,36,114, 0.57 ,79,42,34,155, 0.78 ,56,22,32,110, 0.55 ,791, 0.66 ,auditory,3,Join study group
ST-710,86,29,115, 0.58 ,45,78,58,181, 0.91 ,49,29,44,122, 0.61 ,53,32,31,116, 0.58 ,44,21,37,102, 0.51 ,75,25,36,136, 0.68 ,772, 0.64 ,kinesthetic,3,Study more
ST-711,83,26,109, 0.55 ,20,70,67,157, 0.79 ,59,55,64,178, 0.89 ,37,37,37,111, 0.56 ,38,63,20,121, 0.61 ,20,20,26,66, 0.33 ,742, 0.62 ,auditory,3,Study more
ST-712,93,97,190, 0.95 ,35,24,26,85, 0.43 ,31,31,60,122, 0.61 ,25,66,34,125, 0.63 ,38,64,22,124, 0.62 ,32,64,33,129, 0.65 ,775, 0.65 ,auditory,5,Study more
ST-713,25,77,102, 0.51 ,50,58,48,156, 0.78 ,51,28,33,112, 0.56 ,57,61,24,142, 0.71 ,49,59,35,143, 0.72 ,68,39,37,144, 0.72 ,799, 0.67 ,visual,4,Practice regularly
ST-714,29,93,122, 0.61 ,22,78,53,153, 0.77 ,28,29,28,85, 0.43 ,58,58,35,151, 0.76 ,37,70,31,138, 0.69 ,35,66,39,140, 0.70 ,789, 0.66 ,kinesthetic,4,Study more
ST-715,29,20,49, 0.25 ,37,49,40,126, 0.63 ,24,66,21,111, 0.56 ,54,69,28,151, 0.76 ,71,72,30,173, 0.87 ,73,32,35,140, 0.70 ,750, 0.63 ,kinesthetic,1,Join study group
ST-716,71,75,146, 0.73 ,23,63,40,126, 0.63 ,29,39,58,126, 0.63 ,35,73,39,147, 0.74 ,53,53,30,136, 0.68 ,68,28,36,132, 0.66 ,813, 0.68 ,visual,4,Practice regularly
ST-717,25,31,56, 0.28 ,29,49,52,130, 0.65 ,43,51,78,172, 0.86 ,57,75,23,155, 0.78 ,31,54,36,121, 0.61 ,70,44,22,136, 0.68 ,770, 0.64 ,visual,4,Join study group
ST-718,62,23,85, 0.43 ,54,77,38,169, 0.85 ,22,54,75,151, 0.76 ,35,69,22,126, 0.63 ,32,53,25,110, 0.55 ,60,36,29,125, 0.63 ,766, 0.64 ,kinesthetic,2,Study more
ST-719,49,32,81, 0.41 ,56,49,54,159, 0.80 ,37,47,45,129, 0.65 ,50,79,30,159, 0.80 ,32,69,27,128, 0.64 ,73,69,35,177, 0.89 ,833, 0.69 ,kinesthetic,1,Study more
ST-720,83,93,176, 0.88 ,31,54,64,149, 0.75 ,49,23,63,135, 0.68 ,57,73,39,169, 0.85 ,27,77,38,142, 0.71 ,51,58,20,129, 0.65 ,900, 0.75 ,kinesthetic,1,Ask questions
ST-721,35,45,80, 0.40 ,53,56,48,157, 0.79 ,47,53,42,142, 0.71 ,58,49,32,139, 0.70 ,57,61,24,142, 0.71 ,43,39,30,112, 0.56 ,772, 0.64 ,auditory,2,Study more
ST-722,82,35,117, 0.59 ,27,35,46,108, 0.54 ,52,64,66,182, 0.91 ,25,26,28,79, 0.40 ,73,47,25,145, 0.73 ,29,46,23,98, 0.49 ,729, 0.61 ,auditory,2,Practice regularly
ST-723,61,43,104, 0.52 ,25,20,20,65, 0.33 ,31,70,79,180, 0.90 ,75,25,39,139, 0.70 ,20,64,24,108, 0.54 ,62,72,30,164, 0.82 ,760, 0.63 ,auditory,3,Practice regularly
ST-724,62,42,104, 0.52 ,30,54,30,114, 0.57 ,23,33,63,119, 0.60 ,20,40,21,81, 0.41 ,60,49,26,135, 0.68 ,54,68,23,145, 0.73 ,698, 0.58 ,kinesthetic,1,Join study group
ST-725,24,58,82, 0.41 ,37,78,31,146, 0.73 ,20,38,78,136, 0.68 ,76,55,22,153, 0.77 ,41,29,30,100, 0.50 ,78,43,26,147, 0.74 ,764, 0.64 ,kinesthetic,1,Ask questions
ST-726,69,42,111, 0.56 ,46,44,55,145, 0.73 ,34,67,34,135, 0.68 ,30,62,37,129, 0.65 ,67,66,29,162, 0.81 ,55,24,23,102, 0.51 ,784, 0.65 ,kinesthetic,5,Study more
ST-727,30,60,90, 0.45 ,57,78,61,196, 0.98 ,29,36,39,104, 0.52 ,24,43,20,87, 0.44 ,38,78,30,146, 0.73 ,61,20,28,109, 0.55 ,732, 0.61 ,auditory,5,Practice regularly
ST-728,98,80,178, 0.89 ,54,46,48,148, 0.74 ,31,78,40,149, 0.75 ,36,56,31,123, 0.62 ,22,69,29,120, 0.60 ,52,20,22,94, 0.47 ,812, 0.68 ,visual,3,Practice regularly
ST-729,87,37,124, 0.62 ,41,78,24,143, 0.72 ,44,62,25,131, 0.66 ,54,51,39,144, 0.72 ,53,34,35,122, 0.61 ,34,22,35,91, 0.46 ,755, 0.63 ,auditory,5,Study more
ST-730,35,37,72, 0.36 ,57,37,70,164, 0.82 ,31,23,71,125, 0.63 ,74,78,35,187, 0.94 ,57,48,22,127, 0.64 ,71,61,38,170, 0.85 ,845, 0.70 ,auditory,3,Practice regularly
ST-731,89,71,160, 0.80 ,25,63,36,124, 0.62 ,20,45,48,113, 0.57 ,57,63,36,156, 0.78 ,44,25,36,105, 0.53 ,79,34,34,147, 0.74 ,805, 0.67 ,visual,2,Join study group
ST-732,98,80,178, 0.89 ,42,54,79,175, 0.88 ,40,76,28,144, 0.72 ,30,21,37,88, 0.44 ,57,73,26,156, 0.78 ,24,77,20,121, 0.61 ,862, 0.72 ,kinesthetic,5,Study more
ST-733,47,68,115, 0.58 ,55,69,63,187, 0.94 ,34,77,21,132, 0.66 ,23,38,20,81, 0.41 ,44,20,20,84, 0.42 ,31,35,32,98, 0.49 ,697, 0.58 ,auditory,4,Join study group
ST-734,85,39,124, 0.62 ,57,56,26,139, 0.70 ,26,46,41,113, 0.57 ,46,23,20,89, 0.45 ,71,31,20,122, 0.61 ,39,44,26,109, 0.55 ,696, 0.58 ,visual,5,Practice regularly
ST-735,79,94,173, 0.87 ,30,48,60,138, 0.69 ,54,72,55,181, 0.91 ,68,39,26,133, 0.67 ,44,70,26,140, 0.70 ,58,69,29,156, 0.78 ,921, 0.77 ,kinesthetic,3,Study more
ST-736,85,94,179, 0.90 ,30,24,50,104, 0.52 ,48,76,47,171, 0.86 ,41,48,30,119, 0.60 ,48,57,25,130, 0.65 ,70,24,38,132, 0.66 ,835, 0.70 ,auditory,1,Study more
ST-737,51,98,149, 0.75 ,21,30,36,87, 0.44 ,47,70,24,141, 0.71 ,63,78,20,161, 0.81 ,40,22,24,86, 0.43 ,73,29,20,122, 0.61 ,746, 0.62 ,kinesthetic,5,Study more
ST-738,93,77,170, 0.85 ,52,50,42,144, 0.72 ,51,43,37,131, 0.66 ,36,74,20,130, 0.65 ,27,67,33,127, 0.64 ,29,35,29,93, 0.47 ,795, 0.66 ,visual,1,Practice regularly
ST-739,64,89,153, 0.77 ,54,21,39,114, 0.57 ,54,55,65,174, 0.87 ,32,30,26,88, 0.44 ,20,75,28,123, 0.62 ,72,78,29,179, 0.90 ,831, 0.69 ,kinesthetic,4,Ask questions
ST-740,91,21,112, 0.56 ,44,60,37,141, 0.71 ,56,66,77,199, 1.00 ,32,62,27,121, 0.61 ,75,61,20,156, 0.78 ,39,37,27,103, 0.52 ,832, 0.69 ,kinesthetic,1,Join study group
ST-741,54,92,146, 0.73 ,26,51,77,154, 0.77 ,36,66,71,173, 0.87 ,32,36,28,96, 0.48 ,45,34,37,116, 0.58 ,61,26,21,108, 0.54 ,793, 0.66 ,visual,1,Join study group
ST-742,53,85,138, 0.69 ,36,71,67,174, 0.87 ,42,41,59,142, 0.71 ,64,55,33,152, 0.76 ,74,72,20,166, 0.83 ,77,32,37,146, 0.73 ,918, 0.77 ,auditory,5,Join study group
ST-743,78,47,125, 0.63 ,46,24,72,142, 0.71 ,48,46,24,118, 0.59 ,27,64,20,111, 0.56 ,65,21,29,115, 0.58 ,45,60,33,138, 0.69 ,749, 0.62 ,kinesthetic,1,Practice regularly
ST-744,84,25,109, 0.55 ,50,51,62,163, 0.82 ,56,27,38,121, 0.61 ,20,29,34,83, 0.42 ,77,59,26,162, 0.81 ,71,52,26,149, 0.75 ,787, 0.66 ,auditory,5,Study more
ST-745,83,26,109, 0.55 ,47,45,52,144, 0.72 ,54,54,63,171, 0.86 ,70,56,33,159, 0.80 ,39,58,29,126, 0.63 ,62,38,20,120, 0.60 ,829, 0.69 ,visual,1,Join study group
ST-746,77,57,134, 0.67 ,33,65,31,129, 0.65 ,38,66,58,162, 0.81 ,48,71,24,143, 0.72 ,25,36,37,98, 0.49 ,36,44,29,109, 0.55 ,775, 0.65 ,auditory,4,Study more
ST-747,51,53,104, 0.52 ,39,28,24,91, 0.46 ,44,58,66,168, 0.84 ,49,55,37,141, 0.71 ,64,21,33,118, 0.59 ,56,29,38,123, 0.62 ,745, 0.62 ,auditory,2,Study more
ST-748,23,53,76, 0.38 ,29,76,53,158, 0.79 ,38,53,36,127, 0.64 ,24,63,28,115, 0.58 ,38,42,23,103, 0.52 ,54,79,23,156, 0.78 ,735, 0.61 ,auditory,3,Ask questions
ST-749,31,68,99, 0.50 ,23,76,21,120, 0.60 ,30,32,65,127, 0.64 ,67,66,33,166, 0.83 ,21,38,25,84, 0.42 ,67,46,28,141, 0.71 ,737, 0.61 ,kinesthetic,5,Join study group
ST-750,21,61,82, 0.41 ,51,58,33,142, 0.71 ,36,61,70,167, 0.84 ,66,56,36,158, 0.79 ,76,20,32,128, 0.64 ,42,72,21,135, 0.68 ,812, 0.68 ,kinesthetic,3,Study more
ST-751,81,48,129, 0.65 ,27,53,63,143, 0.72 ,37,78,35,150, 0.75 ,38,52,31,121, 0.61 ,58,70,27,155, 0.78 ,39,51,28,118, 0.59 ,816, 0.68 ,auditory,1,Ask questions
ST-752,24,53,77, 0.39 ,47,79,45,171, 0.86 ,57,32,74,163, 0.82 ,23,49,35,107, 0.54 ,70,44,39,153, 0.77 ,78,36,31,145, 0.73 ,816, 0.68 ,auditory,3,Ask questions
ST-753,69,27,96, 0.48 ,40,28,22,90, 0.45 ,26,63,38,127, 0.64 ,35,43,37,115, 0.58 ,61,64,39,164, 0.82 ,72,73,21,166, 0.83 ,758, 0.63 ,visual,2,Ask questions
ST-754,23,44,67, 0.34 ,24,42,53,119, 0.60 ,21,51,28,100, 0.50 ,45,26,34,105, 0.53 ,72,57,34,163, 0.82 ,42,27,30,99, 0.50 ,653, 0.54 ,visual,1,Ask questions
ST-755,78,37,115, 0.58 ,48,57,56,161, 0.81 ,47,48,43,138, 0.69 ,47,24,22,93, 0.47 ,23,31,28,82, 0.41 ,48,66,33,147, 0.74 ,736, 0.61 ,visual,2,Join study group
ST-756,63,81,144, 0.72 ,26,77,21,124, 0.62 ,54,76,73,203, 1.02 ,38,75,31,144, 0.72 ,46,31,21,98, 0.49 ,69,24,31,124, 0.62 ,837, 0.70 ,kinesthetic,4,Ask questions
ST-757,51,28,79, 0.40 ,40,60,25,125, 0.63 ,50,31,43,124, 0.62 ,67,70,31,168, 0.84 ,71,53,28,152, 0.76 ,49,66,23,138, 0.69 ,786, 0.66 ,auditory,3,Study more
ST-758,50,31,81, 0.41 ,49,43,48,140, 0.70 ,22,72,58,152, 0.76 ,43,57,20,120, 0.60 ,53,75,29,157, 0.79 ,27,38,31,96, 0.48 ,746, 0.62 ,kinesthetic,2,Ask questions
ST-759,70,45,115, 0.58 ,55,28,71,154, 0.77 ,32,27,57,116, 0.58 ,68,72,30,170, 0.85 ,34,66,31,131, 0.66 ,34,63,28,125, 0.63 ,811, 0.68 ,kinesthetic,3,Practice regularly
ST-760,66,52,118, 0.59 ,30,54,34,118, 0.59 ,57,77,22,156, 0.78 ,67,76,23,166, 0.83 ,53,32,21,106, 0.53 ,47,46,34,127, 0.64 ,791, 0.66 ,kinesthetic,2,Study more
ST-761,63,64,127, 0.64 ,46,37,25,108, 0.54 ,49,63,51,163, 0.82 ,60,47,30,137, 0.69 ,49,39,31,119, 0.60 ,69,65,24,158, 0.79 ,812, 0.68 ,auditory,3,Study more
ST-762,87,60,147, 0.74 ,25,37,39,101, 0.51 ,53,67,41,161, 0.81 ,49,26,20,95, 0.48 ,38,62,29,129, 0.65 ,71,24,33,128, 0.64 ,761, 0.63 ,visual,3,Practice regularly
ST-763,93,63,156, 0.78 ,56,27,47,130, 0.65 ,57,24,64,145, 0.73 ,76,46,32,154, 0.77 ,61,24,38,123, 0.62 ,31,43,26,100, 0.50 ,808, 0.67 ,kinesthetic,4,Ask questions
ST-764,46,50,96, 0.48 ,58,37,69,164, 0.82 ,37,71,20,128, 0.64 ,30,26,26,82, 0.41 ,66,25,39,130, 0.65 ,72,20,37,129, 0.65 ,729, 0.61 ,visual,3,Study more
ST-765,24,64,88, 0.44 ,23,55,38,116, 0.58 ,33,67,60,160, 0.80 ,60,32,27,119, 0.60 ,30,30,37,97, 0.49 ,38,59,26,123, 0.62 ,703, 0.59 ,auditory,2,Practice regularly
ST-766,35,52,87, 0.44 ,38,40,75,153, 0.77 ,35,53,38,126, 0.63 ,75,72,30,177, 0.89 ,37,75,37,149, 0.75 ,71,50,39,160, 0.80 ,852, 0.71 ,visual,4,Practice regularly
ST-767,56,92,148, 0.74 ,28,22,36,86, 0.43 ,44,77,38,159, 0.80 ,25,52,25,102, 0.51 ,29,79,25,133, 0.67 ,20,65,35,120, 0.60 ,748, 0.62 ,visual,4,Ask questions
ST-768,59,58,117, 0.59 ,45,36,60,141, 0.71 ,28,36,41,105, 0.53 ,26,71,30,127, 0.64 ,25,24,24,73, 0.37 ,36,33,31,100, 0.50 ,663, 0.55 ,visual,5,Study more
ST-769,59,87,146, 0.73 ,38,56,38,132, 0.66 ,43,25,49,117, 0.59 ,69,62,20,151, 0.76 ,25,66,30,121, 0.61 ,33,55,22,110, 0.55 ,777, 0.65 ,auditory,3,Study more
ST-770,40,64,104, 0.52 ,45,41,44,130, 0.65 ,45,20,25,90, 0.45 ,64,53,37,154, 0.77 ,61,33,26,120, 0.60 ,43,53,39,135, 0.68 ,733, 0.61 ,visual,5,Practice regularly
ST-771,21,28,49, 0.25 ,57,68,66,191, 0.96 ,47,57,25,129, 0.65 ,67,50,25,142, 0.71 ,39,66,38,143, 0.72 ,55,40,33,128, 0.64 ,782, 0.65 ,auditory,2,Join study group
ST-772,45,31,76, 0.38 ,48,45,75,168, 0.84 ,35,51,23,109, 0.55 ,69,23,24,116, 0.58 ,47,55,38,140, 0.70 ,25,59,33,117, 0.59 ,726, 0.61 ,visual,4,Ask questions
ST-773,67,91,158, 0.79 ,39,48,74,161, 0.81 ,49,70,61,180, 0.90 ,36,46,33,115, 0.58 ,36,74,31,141, 0.71 ,78,69,29,176, 0.88 ,931, 0.78 ,auditory,5,Study more
ST-774,59,47,106, 0.53 ,52,47,39,138, 0.69 ,46,54,52,152, 0.76 ,48,54,39,141, 0.71 ,55,53,38,146, 0.73 ,38,61,39,138, 0.69 ,821, 0.68 ,kinesthetic,4,Join study group
ST-775,60,36,96, 0.48 ,53,40,70,163, 0.82 ,53,22,71,146, 0.73 ,65,27,24,116, 0.58 ,78,74,20,172, 0.86 ,23,28,36,87, 0.44 ,780, 0.65 ,kinesthetic,2,Practice regularly
ST-776,74,41,115, 0.58 ,47,60,72,179, 0.90 ,31,65,79,175, 0.88 ,67,64,33,164, 0.82 ,23,38,39,100, 0.50 ,25,23,22,70, 0.35 ,803, 0.67 ,kinesthetic,5,Join study group
ST-777,86,71,157, 0.79 ,24,31,32,87, 0.44 ,23,34,65,122, 0.61 ,27,76,24,127, 0.64 ,62,69,23,154, 0.77 ,78,38,21,137, 0.69 ,784, 0.65 ,visual,5,Ask questions
ST-778,40,78,118, 0.59 ,28,64,79,171, 0.86 ,54,29,32,115, 0.58 ,30,29,24,83, 0.42 ,48,28,31,107, 0.54 ,45,50,32,127, 0.64 ,721, 0.60 ,auditory,1,Join study group
ST-779,20,69,89, 0.45 ,50,75,76,201, 1.01 ,24,32,69,125, 0.63 ,23,74,29,126, 0.63 ,31,26,31,88, 0.44 ,73,63,33,169, 0.85 ,798, 0.67 ,kinesthetic,1,Practice regularly
ST-780,51,63,114, 0.57 ,25,56,29,110, 0.55 ,46,64,39,149, 0.75 ,42,59,21,122, 0.61 ,58,33,32,123, 0.62 ,47,72,39,158, 0.79 ,776, 0.65 ,visual,5,Ask questions
ST-781,40,80,120, 0.60 ,47,46,45,138, 0.69 ,41,30,33,104, 0.52 ,23,30,20,73, 0.37 ,33,58,36,127, 0.64 ,46,77,31,154, 0.77 ,716, 0.60 ,kinesthetic,4,Study more
ST-782,94,95,189, 0.95 ,46,30,67,143, 0.72 ,28,41,57,126, 0.63 ,66,39,23,128, 0.64 ,72,42,21,135, 0.68 ,20,37,24,81, 0.41 ,802, 0.67 ,auditory,2,Join study group
ST-783,24,53,77, 0.39 ,54,27,61,142, 0.71 ,46,25,26,97, 0.49 ,50,70,30,150, 0.75 ,47,58,37,142, 0.71 ,20,47,23,90, 0.45 ,698, 0.58 ,visual,1,Join study group
ST-784,62,80,142, 0.71 ,30,29,26,85, 0.43 ,45,26,32,103, 0.52 ,76,37,38,151, 0.76 ,72,72,39,183, 0.92 ,51,61,26,138, 0.69 ,802, 0.67 ,visual,3,Ask questions
ST-785,71,93,164, 0.82 ,31,68,59,158, 0.79 ,44,33,35,112, 0.56 ,34,33,36,103, 0.52 ,67,74,21,162, 0.81 ,51,63,32,146, 0.73 ,845, 0.70 ,auditory,4,Join study group
ST-786,52,90,142, 0.71 ,28,51,69,148, 0.74 ,57,45,59,161, 0.81 ,42,48,30,120, 0.60 ,58,56,32,146, 0.73 ,69,26,30,125, 0.63 ,842, 0.70 ,auditory,5,Study more
ST-787,90,88,178, 0.89 ,59,45,49,153, 0.77 ,21,51,44,116, 0.58 ,33,60,37,130, 0.65 ,20,60,22,102, 0.51 ,52,71,35,158, 0.79 ,837, 0.70 ,kinesthetic,2,Study more
ST-788,78,30,108, 0.54 ,32,30,66,128, 0.64 ,58,74,38,170, 0.85 ,40,32,25,97, 0.49 ,37,37,29,103, 0.52 ,73,79,20,172, 0.86 ,778, 0.65 ,visual,1,Join study group
ST-789,25,42,67, 0.34 ,22,42,33,97, 0.49 ,20,70,40,130, 0.65 ,72,72,38,182, 0.91 ,39,42,23,104, 0.52 ,72,63,23,158, 0.79 ,738, 0.62 ,auditory,1,Study more
ST-790,52,68,120, 0.60 ,59,67,30,156, 0.78 ,58,62,70,190, 0.95 ,23,32,31,86, 0.43 ,64,42,27,133, 0.67 ,26,68,23,117, 0.59 ,802, 0.67 ,kinesthetic,4,Join study group
ST-791,83,97,180, 0.90 ,59,37,36,132, 0.66 ,23,20,49,92, 0.46 ,21,24,37,82, 0.41 ,67,72,30,169, 0.85 ,23,39,24,86, 0.43 ,741, 0.62 ,kinesthetic,4,Ask questions
ST-792,81,85,166, 0.83 ,58,64,55,177, 0.89 ,25,79,32,136, 0.68 ,51,23,31,105, 0.53 ,73,24,34,131, 0.66 ,50,65,21,136, 0.68 ,851, 0.71 ,visual,3,Study more
ST-793,90,87,177, 0.89 ,37,62,51,150, 0.75 ,54,66,42,162, 0.81 ,63,61,25,149, 0.75 ,63,41,33,137, 0.69 ,29,23,34,86, 0.43 ,861, 0.72 ,visual,2,Practice regularly
ST-794,81,91,172, 0.86 ,50,66,34,150, 0.75 ,50,37,73,160, 0.80 ,55,32,35,122, 0.61 ,72,77,20,169, 0.85 ,63,37,26,126, 0.63 ,899, 0.75 ,auditory,5,Ask questions
ST-795,23,42,65, 0.33 ,35,76,56,167, 0.84 ,46,38,46,130, 0.65 ,79,64,37,180, 0.90 ,65,79,33,177, 0.89 ,64,36,22,122, 0.61 ,841, 0.70 ,auditory,2,Ask questions
ST-796,60,57,117, 0.59 ,29,32,69,130, 0.65 ,31,24,77,132, 0.66 ,62,53,21,136, 0.68 ,51,49,38,138, 0.69 ,67,22,30,119, 0.60 ,772, 0.64 ,visual,2,Ask questions
ST-797,76,23,99, 0.50 ,23,70,44,137, 0.69 ,57,36,66,159, 0.80 ,75,63,22,160, 0.80 ,72,21,24,117, 0.59 ,72,56,30,158, 0.79 ,830, 0.69 ,visual,4,Join study group
ST-798,85,44,129, 0.65 ,53,55,65,173, 0.87 ,54,30,75,159, 0.80 ,25,55,20,100, 0.50 ,71,66,39,176, 0.88 ,63,29,27,119, 0.60 ,856, 0.71 ,kinesthetic,2,Practice regularly
ST-799,76,23,99, 0.50 ,46,53,51,150, 0.75 ,29,67,71,167, 0.84 ,29,28,22,79, 0.40 ,60,78,32,170, 0.85 ,45,79,35,159, 0.80 ,824, 0.69 ,kinesthetic,1,Ask questions
ST-800,53,70,123, 0.62 ,37,52,47,136, 0.68 ,25,45,28,98, 0.49 ,22,49,24,95, 0.48 ,38,23,29,90, 0.45 ,57,28,26,111, 0.56 ,653, 0.54 ,visual,3,Study more
ST-801,43,49,92, 0.46 ,36,23,73,132, 0.66 ,45,39,47,131, 0.66 ,41,68,31,140, 0.70 ,70,29,26,125, 0.63 ,46,74,26,146, 0.73 ,766, 0.64 ,kinesthetic,2,Ask questions
ST-802,24,99,123, 0.62 ,49,20,78,147, 0.74 ,55,63,71,189, 0.95 ,21,30,20,71, 0.36 ,20,39,32,91, 0.46 ,61,43,38,142, 0.71 ,763, 0.64 ,kinesthetic,3,Study more
ST-803,73,41,114, 0.57 ,26,46,43,115, 0.58 ,25,56,39,120, 0.60 ,64,25,34,123, 0.62 ,31,55,30,116, 0.58 ,33,53,27,113, 0.57 ,701, 0.58 ,auditory,2,Practice regularly
ST-804,84,52,136, 0.68 ,28,58,49,135, 0.68 ,52,71,47,170, 0.85 ,39,35,22,96, 0.48 ,62,69,37,168, 0.84 ,62,49,39,150, 0.75 ,855, 0.71 ,auditory,3,Study more
ST-805,84,67,151, 0.76 ,48,66,63,177, 0.89 ,55,36,75,166, 0.83 ,50,26,28,104, 0.52 ,75,42,30,147, 0.74 ,41,61,21,123, 0.62 ,868, 0.72 ,auditory,5,Study more
ST-806,82,39,121, 0.61 ,25,26,21,72, 0.36 ,33,53,30,116, 0.58 ,36,65,37,138, 0.69 ,62,57,31,150, 0.75 ,75,28,31,134, 0.67 ,731, 0.61 ,visual,4,Study more
ST-807,78,72,150, 0.75 ,57,62,48,167, 0.84 ,28,21,35,84, 0.42 ,56,71,21,148, 0.74 ,41,52,39,132, 0.66 ,31,54,24,109, 0.55 ,790, 0.66 ,kinesthetic,2,Ask questions
ST-808,81,74,155, 0.78 ,54,23,68,145, 0.73 ,45,61,23,129, 0.65 ,50,47,28,125, 0.63 ,65,41,23,129, 0.65 ,54,65,23,142, 0.71 ,825, 0.69 ,kinesthetic,2,Join study group
ST-809,39,60,99, 0.50 ,53,27,53,133, 0.67 ,37,66,39,142, 0.71 ,25,64,23,112, 0.56 ,76,71,20,167, 0.84 ,51,70,22,143, 0.72 ,796, 0.66 ,auditory,5,Join study group
ST-810,27,36,63, 0.32 ,50,55,72,177, 0.89 ,28,42,42,112, 0.56 ,53,44,26,123, 0.62 ,59,68,26,153, 0.77 ,63,20,24,107, 0.54 ,735, 0.61 ,kinesthetic,5,Ask questions
ST-811,83,44,127, 0.64 ,29,47,26,102, 0.51 ,42,35,53,130, 0.65 ,69,43,29,141, 0.71 ,24,57,32,113, 0.57 ,46,42,26,114, 0.57 ,727, 0.61 ,kinesthetic,4,Study more
ST-812,38,82,120, 0.60 ,21,72,75,168, 0.84 ,58,42,78,178, 0.89 ,47,78,27,152, 0.76 ,50,66,28,144, 0.72 ,33,37,33,103, 0.52 ,865, 0.72 ,visual,3,Practice regularly
ST-813,57,70,127, 0.64 ,49,65,55,169, 0.85 ,48,33,40,121, 0.61 ,43,38,24,105, 0.53 ,62,20,27,109, 0.55 ,78,30,34,142, 0.71 ,773, 0.64 ,auditory,1,Join study group
ST-814,20,80,100, 0.50 ,53,41,36,130, 0.65 ,36,52,74,162, 0.81 ,63,53,20,136, 0.68 ,42,77,35,154, 0.77 ,40,44,30,114, 0.57 ,796, 0.66 ,visual,5,Study more
ST-815,97,66,163, 0.82 ,55,49,43,147, 0.74 ,58,53,33,144, 0.72 ,30,35,39,104, 0.52 ,76,33,29,138, 0.69 ,77,40,23,140, 0.70 ,836, 0.70 ,kinesthetic,3,Join study group
ST-816,28,53,81, 0.41 ,35,20,61,116, 0.58 ,41,55,51,147, 0.74 ,54,23,23,100, 0.50 ,27,24,22,73, 0.37 ,33,41,22,96, 0.48 ,613, 0.51 ,auditory,5,Practice regularly
ST-817,49,33,82, 0.41 ,47,69,72,188, 0.94 ,53,52,33,138, 0.69 ,33,22,25,80, 0.40 ,50,78,35,163, 0.82 ,68,63,36,167, 0.84 ,818, 0.68 ,visual,4,Practice regularly
ST-818,83,39,122, 0.61 ,33,48,79,160, 0.80 ,38,68,30,136, 0.68 ,27,79,33,139, 0.70 ,70,53,34,157, 0.79 ,66,21,33,120, 0.60 ,834, 0.70 ,kinesthetic,5,Join study group
ST-819,74,56,130, 0.65 ,32,36,69,137, 0.69 ,25,20,21,66, 0.33 ,40,36,31,107, 0.54 ,33,46,32,111, 0.56 ,54,37,33,124, 0.62 ,675, 0.56 ,visual,4,Join study group
ST-820,51,55,106, 0.53 ,24,54,70,148, 0.74 ,55,77,34,166, 0.83 ,48,36,28,112, 0.56 ,60,48,39,147, 0.74 ,23,76,27,126, 0.63 ,805, 0.67 ,auditory,2,Study more
ST-821,91,31,122, 0.61 ,36,48,55,139, 0.70 ,22,25,50,97, 0.49 ,32,66,35,133, 0.67 ,44,36,24,104, 0.52 ,30,68,34,132, 0.66 ,727, 0.61 ,auditory,3,Ask questions
ST-822,73,65,138, 0.69 ,21,47,53,121, 0.61 ,58,74,47,179, 0.90 ,73,30,30,133, 0.67 ,56,22,23,101, 0.51 ,33,40,33,106, 0.53 ,778, 0.65 ,auditory,3,Practice regularly
ST-823,27,30,57, 0.29 ,36,33,71,140, 0.70 ,39,32,46,117, 0.59 ,41,45,29,115, 0.58 ,23,58,38,119, 0.60 ,67,43,39,149, 0.75 ,697, 0.58 ,visual,1,Ask questions
ST-824,85,40,125, 0.63 ,28,64,51,143, 0.72 ,39,40,46,125, 0.63 ,59,56,24,139, 0.70 ,45,45,32,122, 0.61 ,36,74,22,132, 0.66 ,786, 0.66 ,auditory,4,Study more
ST-825,99,51,150, 0.75 ,49,68,79,196, 0.98 ,28,70,55,153, 0.77 ,27,62,22,111, 0.56 ,69,35,20,124, 0.62 ,62,67,21,150, 0.75 ,884, 0.74 ,auditory,4,Join study group
ST-826,87,26,113, 0.57 ,44,65,65,174, 0.87 ,27,63,43,133, 0.67 ,38,48,31,117, 0.59 ,30,67,29,126, 0.63 ,32,43,30,105, 0.53 ,768, 0.64 ,visual,4,Join study group
ST-827,83,42,125, 0.63 ,37,60,70,167, 0.84 ,25,21,38,84, 0.42 ,25,61,25,111, 0.56 ,39,70,31,140, 0.70 ,20,55,37,112, 0.56 ,739, 0.62 ,visual,4,Practice regularly
ST-828,73,85,158, 0.79 ,29,72,65,166, 0.83 ,29,29,38,96, 0.48 ,54,37,37,128, 0.64 ,58,64,32,154, 0.77 ,34,57,28,119, 0.60 ,821, 0.68 ,visual,5,Practice regularly
ST-829,60,98,158, 0.79 ,56,41,30,127, 0.64 ,55,78,60,193, 0.97 ,67,70,31,168, 0.84 ,77,23,31,131, 0.66 ,30,23,22,75, 0.38 ,852, 0.71 ,kinesthetic,1,Ask questions
ST-830,95,36,131, 0.66 ,45,55,45,145, 0.73 ,21,30,59,110, 0.55 ,68,54,35,157, 0.79 ,45,52,26,123, 0.62 ,67,40,35,142, 0.71 ,808, 0.67 ,auditory,1,Study more
ST-831,69,68,137, 0.69 ,54,62,63,179, 0.90 ,21,56,30,107, 0.54 ,33,79,24,136, 0.68 ,65,61,24,150, 0.75 ,46,59,38,143, 0.72 ,852, 0.71 ,auditory,4,Ask questions
ST-832,36,95,131, 0.66 ,40,52,30,122, 0.61 ,35,75,53,163, 0.82 ,71,54,38,163, 0.82 ,77,38,37,152, 0.76 ,36,37,23,96, 0.48 ,827, 0.69 ,kinesthetic,5,Join study group
ST-833,76,74,150, 0.75 ,40,32,21,93, 0.47 ,58,48,20,126, 0.63 ,43,62,23,128, 0.64 ,62,20,22,104, 0.52 ,54,52,39,145, 0.73 ,746, 0.62 ,kinesthetic,1,Ask questions
ST-834,73,94,167, 0.84 ,27,64,72,163, 0.82 ,43,63,53,159, 0.80 ,27,65,38,130, 0.65 ,54,74,21,149, 0.75 ,52,76,37,165, 0.83 ,933, 0.78 ,kinesthetic,1,Ask questions
ST-835,56,67,123, 0.62 ,27,53,36,116, 0.58 ,35,49,60,144, 0.72 ,51,41,26,118, 0.59 ,28,50,24,102, 0.51 ,42,76,33,151, 0.76 ,754, 0.63 ,auditory,2,Study more
ST-836,77,32,109, 0.55 ,33,37,54,124, 0.62 ,36,21,42,99, 0.50 ,53,31,23,107, 0.54 ,46,34,38,118, 0.59 ,26,40,36,102, 0.51 ,659, 0.55 ,visual,2,Ask questions
ST-837,90,92,182, 0.91 ,33,69,73,175, 0.88 ,43,31,39,113, 0.57 ,71,31,21,123, 0.62 ,62,45,22,129, 0.65 ,60,26,29,115, 0.58 ,837, 0.70 ,auditory,1,Ask questions
ST-838,27,47,74, 0.37 ,58,52,71,181, 0.91 ,35,52,52,139, 0.70 ,65,58,30,153, 0.77 ,26,20,20,66, 0.33 ,74,68,35,177, 0.89 ,790, 0.66 ,kinesthetic,1,Practice regularly
ST-839,20,38,58, 0.29 ,58,23,22,103, 0.52 ,47,71,58,176, 0.88 ,73,29,35,137, 0.69 ,35,64,23,122, 0.61 ,67,78,36,181, 0.91 ,777, 0.65 ,kinesthetic,3,Study more
ST-840,68,73,141, 0.71 ,23,31,29,83, 0.42 ,49,72,64,185, 0.93 ,37,72,30,139, 0.70 ,24,20,35,79, 0.40 ,76,49,29,154, 0.77 ,781, 0.65 ,auditory,2,Practice regularly
ST-841,75,90,165, 0.83 ,39,53,23,115, 0.58 ,52,56,72,180, 0.90 ,31,55,29,115, 0.58 ,52,42,31,125, 0.63 ,33,35,35,103, 0.52 ,803, 0.67 ,kinesthetic,3,Join study group
ST-842,38,99,137, 0.69 ,49,69,60,178, 0.89 ,36,40,49,125, 0.63 ,41,48,30,119, 0.60 ,26,25,29,80, 0.40 ,40,61,27,128, 0.64 ,767, 0.64 ,kinesthetic,5,Practice regularly
ST-843,44,52,96, 0.48 ,57,52,43,152, 0.76 ,27,41,26,94, 0.47 ,59,36,25,120, 0.60 ,58,68,32,158, 0.79 ,50,28,32,110, 0.55 ,730, 0.61 ,auditory,3,Join study group
ST-844,37,36,73, 0.37 ,43,71,78,192, 0.96 ,31,22,27,80, 0.40 ,60,78,39,177, 0.89 ,29,68,20,117, 0.59 ,59,60,22,141, 0.71 ,780, 0.65 ,visual,4,Practice regularly
ST-845,93,95,188, 0.94 ,34,34,65,133, 0.67 ,47,64,39,150, 0.75 ,72,36,31,139, 0.70 ,22,60,29,111, 0.56 ,52,21,27,100, 0.50 ,821, 0.68 ,auditory,2,Ask questions
ST-846,39,60,99, 0.50 ,40,30,47,117, 0.59 ,48,27,41,116, 0.58 ,72,79,21,172, 0.86 ,62,30,25,117, 0.59 ,35,77,23,135, 0.68 ,756, 0.63 ,auditory,4,Ask questions
ST-847,68,64,132, 0.66 ,37,46,74,157, 0.79 ,21,66,77,164, 0.82 ,68,68,32,168, 0.84 ,22,69,29,120, 0.60 ,54,75,32,161, 0.81 ,902, 0.75 ,kinesthetic,1,Join study group
ST-848,65,48,113, 0.57 ,52,41,41,134, 0.67 ,46,66,78,190, 0.95 ,56,60,39,155, 0.78 ,34,76,24,134, 0.67 ,51,36,22,109, 0.55 ,835, 0.70 ,visual,5,Study more
ST-849,24,31,55, 0.28 ,43,46,34,123, 0.62 ,46,28,78,152, 0.76 ,37,74,23,134, 0.67 ,58,57,33,148, 0.74 ,67,32,39,138, 0.69 ,750, 0.63 ,auditory,2,Practice regularly
ST-850,48,67,115, 0.58 ,58,45,74,177, 0.89 ,56,79,58,193, 0.97 ,79,31,26,136, 0.68 ,42,31,29,102, 0.51 ,53,54,24,131, 0.66 ,854, 0.71 ,visual,5,Study more
ST-851,58,74,132, 0.66 ,57,77,56,190, 0.95 ,52,78,69,199, 1.00 ,22,69,26,117, 0.59 ,50,71,23,144, 0.72 ,75,28,33,136, 0.68 ,918, 0.77 ,visual,5,Practice regularly
ST-852,23,78,101, 0.51 ,37,43,66,146, 0.73 ,49,59,27,135, 0.68 ,78,68,22,168, 0.84 ,59,32,26,117, 0.59 ,76,22,23,121, 0.61 ,788, 0.66 ,kinesthetic,3,Ask questions
ST-853,67,35,102, 0.51 ,48,42,64,154, 0.77 ,44,52,22,118, 0.59 ,46,47,20,113, 0.57 ,27,27,28,82, 0.41 ,71,74,33,178, 0.89 ,747, 0.62 ,visual,2,Study more
ST-854,51,92,143, 0.72 ,41,44,67,152, 0.76 ,21,24,34,79, 0.40 ,46,63,35,144, 0.72 ,56,77,37,170, 0.85 ,75,41,37,153, 0.77 ,841, 0.70 ,visual,4,Join study group
ST-855,29,46,75, 0.38 ,49,78,30,157, 0.79 ,36,71,72,179, 0.90 ,69,25,33,127, 0.64 ,65,79,23,167, 0.84 ,69,30,38,137, 0.69 ,842, 0.70 ,visual,5,Study more
ST-856,95,79,174, 0.87 ,28,37,31,96, 0.48 ,47,41,59,147, 0.74 ,77,31,25,133, 0.67 ,60,54,31,145, 0.73 ,66,77,37,180, 0.90 ,875, 0.73 ,visual,2,Practice regularly
ST-857,94,33,127, 0.64 ,53,39,72,164, 0.82 ,36,60,50,146, 0.73 ,47,39,21,107, 0.54 ,31,31,37,99, 0.50 ,41,46,30,117, 0.59 ,760, 0.63 ,visual,3,Ask questions
ST-858,45,86,131, 0.66 ,51,58,52,161, 0.81 ,43,62,31,136, 0.68 ,55,51,27,133, 0.67 ,20,74,35,129, 0.65 ,29,75,34,138, 0.69 ,828, 0.69 ,kinesthetic,2,Practice regularly
ST-859,50,98,148, 0.74 ,54,21,37,112, 0.56 ,43,38,72,153, 0.77 ,79,46,37,162, 0.81 ,62,69,33,164, 0.82 ,52,54,27,133, 0.67 ,872, 0.73 ,auditory,3,Ask questions
ST-860,77,55,132, 0.66 ,28,29,54,111, 0.56 ,54,23,25,102, 0.51 ,21,70,29,120, 0.60 ,34,56,27,117, 0.59 ,32,42,39,113, 0.57 ,695, 0.58 ,kinesthetic,4,Ask questions
ST-861,66,42,108, 0.54 ,59,42,58,159, 0.80 ,30,66,36,132, 0.66 ,23,72,28,123, 0.62 ,56,35,37,128, 0.64 ,61,33,30,124, 0.62 ,774, 0.65 ,visual,4,Join study group
ST-862,34,35,69, 0.35 ,44,68,49,161, 0.81 ,31,50,72,153, 0.77 ,63,44,28,135, 0.68 ,39,22,38,99, 0.50 ,77,48,32,157, 0.79 ,774, 0.65 ,visual,1,Join study group
ST-863,45,45,90, 0.45 ,38,79,38,155, 0.78 ,36,76,52,164, 0.82 ,54,30,30,114, 0.57 ,28,49,39,116, 0.58 ,36,33,28,97, 0.49 ,736, 0.61 ,visual,4,Study more
ST-864,33,80,113, 0.57 ,24,42,60,126, 0.63 ,31,27,34,92, 0.46 ,77,72,23,172, 0.86 ,36,20,23,79, 0.40 ,54,67,20,141, 0.71 ,723, 0.60 ,visual,1,Practice regularly
ST-865,24,28,52, 0.26 ,23,48,33,104, 0.52 ,31,66,24,121, 0.61 ,35,63,32,130, 0.65 ,20,43,24,87, 0.44 ,44,30,36,110, 0.55 ,604, 0.50 ,auditory,2,Ask questions
ST-866,86,41,127, 0.64 ,56,34,73,163, 0.82 ,21,42,47,110, 0.55 ,37,64,34,135, 0.68 ,27,24,26,77, 0.39 ,27,39,22,88, 0.44 ,700, 0.58 ,auditory,5,Ask questions
ST-867,53,36,89, 0.45 ,59,54,54,167, 0.84 ,44,62,44,150, 0.75 ,55,43,31,129, 0.65 ,70,74,38,182, 0.91 ,65,41,25,131, 0.66 ,848, 0.71 ,visual,3,Practice regularly
ST-868,71,67,138, 0.69 ,46,77,68,191, 0.96 ,59,72,46,177, 0.89 ,61,33,24,118, 0.59 ,35,45,36,116, 0.58 ,53,62,25,140, 0.70 ,880, 0.73 ,auditory,5,Practice regularly
ST-869,91,85,176, 0.88 ,24,38,54,116, 0.58 ,34,74,50,158, 0.79 ,61,73,21,155, 0.78 ,73,22,34,129, 0.65 ,31,39,26,96, 0.48 ,830, 0.69 ,visual,3,Practice regularly
ST-870,83,37,120, 0.60 ,38,62,70,170, 0.85 ,23,76,32,131, 0.66 ,64,39,39,142, 0.71 ,77,36,31,144, 0.72 ,65,42,22,129, 0.65 ,836, 0.70 ,kinesthetic,2,Ask questions
ST-871,39,76,115, 0.58 ,47,41,66,154, 0.77 ,30,20,44,94, 0.47 ,59,77,35,171, 0.86 ,41,72,29,142, 0.71 ,33,56,21,110, 0.55 ,786, 0.66 ,visual,1,Ask questions
ST-872,30,83,113, 0.57 ,43,43,24,110, 0.55 ,54,69,28,151, 0.76 ,75,73,24,172, 0.86 ,78,66,22,166, 0.83 ,30,60,22,112, 0.56 ,824, 0.69 ,visual,5,Practice regularly
ST-873,65,56,121, 0.61 ,29,25,44,98, 0.49 ,54,65,59,178, 0.89 ,65,40,34,139, 0.70 ,50,59,38,147, 0.74 ,74,40,26,140, 0.70 ,823, 0.69 ,kinesthetic,5,Study more
ST-874,88,26,114, 0.57 ,29,28,62,119, 0.60 ,33,46,48,127, 0.64 ,32,29,23,84, 0.42 ,37,44,26,107, 0.54 ,46,38,28,112, 0.56 ,663, 0.55 ,auditory,3,Study more
ST-875,58,81,139, 0.70 ,54,61,37,152, 0.76 ,29,49,75,153, 0.77 ,68,46,37,151, 0.76 ,40,49,22,111, 0.56 ,29,78,29,136, 0.68 ,842, 0.70 ,auditory,5,Study more
ST-876,91,36,127, 0.64 ,52,60,52,164, 0.82 ,33,22,61,116, 0.58 ,27,47,27,101, 0.51 ,76,68,39,183, 0.92 ,42,55,25,122, 0.61 ,813, 0.68 ,visual,2,Join study group
ST-877,92,93,185, 0.93 ,36,63,56,155, 0.78 ,41,31,63,135, 0.68 ,51,35,24,110, 0.55 ,50,54,37,141, 0.71 ,35,35,36,106, 0.53 ,832, 0.69 ,visual,2,Join study group
ST-878,21,79,100, 0.50 ,50,39,32,121, 0.61 ,35,63,43,141, 0.71 ,59,32,32,123, 0.62 ,63,24,39,126, 0.63 ,52,32,22,106, 0.53 ,717, 0.60 ,kinesthetic,1,Join study group
ST-879,38,89,127, 0.64 ,38,57,57,152, 0.76 ,31,37,62,130, 0.65 ,34,25,36,95, 0.48 ,69,38,22,129, 0.65 ,30,42,24,96, 0.48 ,729, 0.61 ,visual,5,Practice regularly
ST-880,60,21,81, 0.41 ,54,60,22,136, 0.68 ,29,67,49,145, 0.73 ,74,49,35,158, 0.79 ,50,68,34,152, 0.76 ,71,65,36,172, 0.86 ,844, 0.70 ,visual,4,Ask questions
ST-881,64,34,98, 0.49 ,52,31,31,114, 0.57 ,46,45,29,120, 0.60 ,55,77,33,165, 0.83 ,71,72,28,171, 0.86 ,72,53,34,159, 0.80 ,827, 0.69 ,auditory,3,Practice regularly
ST-882,61,39,100, 0.50 ,58,34,50,142, 0.71 ,41,30,30,101, 0.51 ,49,48,25,122, 0.61 ,54,75,32,161, 0.81 ,57,52,38,147, 0.74 ,773, 0.64 ,auditory,1,Join study group
ST-883,86,28,114, 0.57 ,24,79,69,172, 0.86 ,32,69,56,157, 0.79 ,36,73,33,142, 0.71 ,74,30,31,135, 0.68 ,33,43,29,105, 0.53 ,825, 0.69 ,visual,1,Join study group
ST-884,41,98,139, 0.70 ,51,31,21,103, 0.52 ,43,21,41,105, 0.53 ,27,55,24,106, 0.53 ,36,34,29,99, 0.50 ,25,27,33,85, 0.43 ,637, 0.53 ,auditory,3,Practice regularly
ST-885,37,81,118, 0.59 ,21,49,79,149, 0.75 ,28,70,69,167, 0.84 ,21,49,27,97, 0.49 ,35,61,33,129, 0.65 ,20,51,39,110, 0.55 ,770, 0.64 ,kinesthetic,2,Ask questions
ST-886,60,29,89, 0.45 ,35,75,58,168, 0.84 ,55,44,25,124, 0.62 ,47,31,36,114, 0.57 ,70,49,25,144, 0.72 ,66,64,38,168, 0.84 ,807, 0.67 ,auditory,2,Join study group
ST-887,27,21,48, 0.24 ,50,77,25,152, 0.76 ,33,31,49,113, 0.57 ,69,59,33,161, 0.81 ,36,21,36,93, 0.47 ,57,44,38,139, 0.70 ,706, 0.59 ,auditory,2,Practice regularly
ST-888,83,59,142, 0.71 ,26,35,29,90, 0.45 ,44,44,77,165, 0.83 ,26,75,31,132, 0.66 ,68,48,31,147, 0.74 ,58,77,23,158, 0.79 ,834, 0.70 ,kinesthetic,2,Join study group
ST-889,49,41,90, 0.45 ,59,25,61,145, 0.73 ,43,73,53,169, 0.85 ,56,45,36,137, 0.69 ,46,33,31,110, 0.55 ,78,20,20,118, 0.59 ,769, 0.64 ,kinesthetic,3,Join study group
ST-890,75,68,143, 0.72 ,34,22,62,118, 0.59 ,33,62,37,132, 0.66 ,33,57,20,110, 0.55 ,75,56,22,153, 0.77 ,65,45,20,130, 0.65 ,786, 0.66 ,auditory,4,Join study group
ST-891,28,68,96, 0.48 ,36,51,58,145, 0.73 ,59,67,37,163, 0.82 ,53,40,33,126, 0.63 ,43,34,29,106, 0.53 ,66,40,23,129, 0.65 ,765, 0.64 ,kinesthetic,5,Ask questions
ST-892,23,55,78, 0.39 ,28,52,35,115, 0.58 ,51,25,44,120, 0.60 ,25,56,34,115, 0.58 ,77,74,38,189, 0.95 ,57,60,21,138, 0.69 ,755, 0.63 ,visual,1,Study more
ST-893,36,32,68, 0.34 ,51,40,50,141, 0.71 ,24,76,26,126, 0.63 ,31,29,27,87, 0.44 ,41,27,32,100, 0.50 ,46,71,39,156, 0.78 ,678, 0.57 ,kinesthetic,3,Study more
ST-894,21,75,96, 0.48 ,53,67,69,189, 0.95 ,51,27,64,142, 0.71 ,67,60,26,153, 0.77 ,64,21,33,118, 0.59 ,34,56,38,128, 0.64 ,826, 0.69 ,auditory,4,Practice regularly
ST-895,65,96,161, 0.81 ,35,47,44,126, 0.63 ,21,67,35,123, 0.62 ,40,30,25,95, 0.48 ,51,75,31,157, 0.79 ,30,40,24,94, 0.47 ,756, 0.63 ,visual,1,Study more
ST-896,73,26,99, 0.50 ,36,63,23,122, 0.61 ,52,27,27,106, 0.53 ,50,64,24,138, 0.69 ,31,27,31,89, 0.45 ,51,34,26,111, 0.56 ,665, 0.55 ,auditory,2,Study more
ST-897,53,99,152, 0.76 ,54,29,63,146, 0.73 ,35,33,24,92, 0.46 ,45,77,35,157, 0.79 ,49,76,28,153, 0.77 ,41,27,35,103, 0.52 ,803, 0.67 ,auditory,1,Ask questions
ST-898,70,27,97, 0.49 ,47,39,63,149, 0.75 ,36,34,71,141, 0.71 ,61,65,31,157, 0.79 ,34,58,23,115, 0.58 ,59,23,29,111, 0.56 ,770, 0.64 ,visual,2,Join study group
ST-899,25,38,63, 0.32 ,23,71,36,130, 0.65 ,45,39,55,139, 0.70 ,53,47,28,128, 0.64 ,67,56,33,156, 0.78 ,76,55,39,170, 0.85 ,786, 0.66 ,visual,3,Practice regularly
ST-900,87,85,172, 0.86 ,34,73,63,170, 0.85 ,56,71,24,151, 0.76 ,63,60,35,158, 0.79 ,31,42,38,111, 0.56 ,78,55,32,165, 0.83 ,927, 0.77 ,kinesthetic,1,Join study group
ST-901,62,51,113, 0.57 ,26,47,30,103, 0.52 ,25,23,22,70, 0.35 ,52,45,23,120, 0.60 ,39,43,35,117, 0.59 ,30,36,28,94, 0.47 ,617, 0.51 ,kinesthetic,1,Ask questions
ST-902,79,71,150, 0.75 ,22,29,66,117, 0.59 ,54,58,66,178, 0.89 ,32,49,23,104, 0.52 ,52,29,26,107, 0.54 ,56,49,22,127, 0.64 ,783, 0.65 ,visual,3,Join study group
ST-903,90,31,121, 0.61 ,34,27,61,122, 0.61 ,35,43,36,114, 0.57 ,69,30,30,129, 0.65 ,71,40,32,143, 0.72 ,53,45,33,131, 0.66 ,760, 0.63 ,auditory,3,Practice regularly
ST-904,68,38,106, 0.53 ,29,21,68,118, 0.59 ,56,25,41,122, 0.61 ,65,22,38,125, 0.63 ,66,39,38,143, 0.72 ,28,71,35,134, 0.67 ,748, 0.62 ,visual,3,Ask questions
ST-905,69,23,92, 0.46 ,54,30,26,110, 0.55 ,48,20,47,115, 0.58 ,32,45,38,115, 0.58 ,31,37,33,101, 0.51 ,46,79,22,147, 0.74 ,680, 0.57 ,auditory,2,Practice regularly
ST-906,46,70,116, 0.58 ,27,35,23,85, 0.43 ,58,42,31,131, 0.66 ,67,37,39,143, 0.72 ,58,46,38,142, 0.71 ,60,25,32,117, 0.59 ,734, 0.61 ,visual,3,Ask questions
ST-907,67,39,106, 0.53 ,37,68,20,125, 0.63 ,36,27,63,126, 0.63 ,52,52,21,125, 0.63 ,40,53,25,118, 0.59 ,22,42,34,98, 0.49 ,698, 0.58 ,auditory,1,Ask questions
ST-908,67,68,135, 0.68 ,59,20,70,149, 0.75 ,43,73,48,164, 0.82 ,35,74,33,142, 0.71 ,75,24,36,135, 0.68 ,29,44,34,107, 0.54 ,832, 0.69 ,visual,4,Practice regularly
ST-909,82,46,128, 0.64 ,55,67,53,175, 0.88 ,41,66,25,132, 0.66 ,30,28,39,97, 0.49 ,27,52,28,107, 0.54 ,23,32,32,87, 0.44 ,726, 0.61 ,kinesthetic,1,Join study group
ST-910,94,26,120, 0.60 ,35,42,74,151, 0.76 ,29,24,58,111, 0.56 ,43,63,31,137, 0.69 ,60,44,33,137, 0.69 ,20,20,30,70, 0.35 ,726, 0.61 ,kinesthetic,4,Join study group
ST-911,93,75,168, 0.84 ,31,50,77,158, 0.79 ,31,29,48,108, 0.54 ,25,36,32,93, 0.47 ,26,66,35,127, 0.64 ,58,34,26,118, 0.59 ,772, 0.64 ,auditory,2,Study more
ST-912,60,38,98, 0.49 ,24,32,66,122, 0.61 ,39,67,79,185, 0.93 ,32,32,33,97, 0.49 ,33,48,29,110, 0.55 ,49,67,33,149, 0.75 ,761, 0.63 ,kinesthetic,2,Ask questions
ST-913,38,98,136, 0.68 ,52,48,31,131, 0.66 ,42,25,61,128, 0.64 ,62,76,24,162, 0.81 ,62,36,34,132, 0.66 ,25,68,22,115, 0.58 ,804, 0.67 ,visual,3,Study more
ST-914,77,79,156, 0.78 ,42,44,54,140, 0.70 ,58,79,67,204, 1.02 ,79,46,23,148, 0.74 ,49,79,30,158, 0.79 ,44,29,32,105, 0.53 ,911, 0.76 ,auditory,1,Study more
ST-915,88,70,158, 0.79 ,37,76,75,188, 0.94 ,26,51,35,112, 0.56 ,71,60,27,158, 0.79 ,49,27,25,101, 0.51 ,42,36,38,116, 0.58 ,833, 0.69 ,auditory,4,Study more
ST-916,24,24,48, 0.24 ,42,69,75,186, 0.93 ,42,59,70,171, 0.86 ,24,59,38,121, 0.61 ,42,43,25,110, 0.55 ,53,24,36,113, 0.57 ,749, 0.62 ,kinesthetic,2,Ask questions
ST-917,80,39,119, 0.60 ,33,22,26,81, 0.41 ,30,34,39,103, 0.52 ,52,52,29,133, 0.67 ,53,49,20,122, 0.61 ,38,31,39,108, 0.54 ,666, 0.56 ,kinesthetic,3,Study more
ST-918,60,21,81, 0.41 ,46,60,55,161, 0.81 ,52,53,24,129, 0.65 ,34,23,29,86, 0.43 ,73,68,28,169, 0.85 ,33,61,28,122, 0.61 ,748, 0.62 ,visual,1,Join study group
ST-919,22,69,91, 0.46 ,42,70,45,157, 0.79 ,51,50,38,139, 0.70 ,31,71,38,140, 0.70 ,53,46,25,124, 0.62 ,51,22,36,109, 0.55 ,760, 0.63 ,auditory,5,Study more
ST-920,26,23,49, 0.25 ,24,29,61,114, 0.57 ,28,76,49,153, 0.77 ,60,32,27,119, 0.60 ,63,22,38,123, 0.62 ,47,53,25,125, 0.63 ,683, 0.57 ,auditory,1,Join study group
ST-921,63,60,123, 0.62 ,43,75,41,159, 0.80 ,32,50,73,155, 0.78 ,38,66,31,135, 0.68 ,58,71,21,150, 0.75 ,39,78,23,140, 0.70 ,862, 0.72 ,auditory,1,Practice regularly
ST-922,78,61,139, 0.70 ,40,57,65,162, 0.81 ,24,35,54,113, 0.57 ,30,54,21,105, 0.53 ,38,57,29,124, 0.62 ,65,58,20,143, 0.72 ,786, 0.66 ,auditory,3,Join study group
ST-923,25,87,112, 0.56 ,59,66,47,172, 0.86 ,22,61,75,158, 0.79 ,44,50,39,133, 0.67 ,50,67,38,155, 0.78 ,59,67,33,159, 0.80 ,889, 0.74 ,visual,5,Practice regularly
ST-924,96,32,128, 0.64 ,23,62,65,150, 0.75 ,37,37,28,102, 0.51 ,30,64,35,129, 0.65 ,54,57,26,137, 0.69 ,42,40,28,110, 0.55 ,756, 0.63 ,visual,5,Practice regularly
ST-925,78,83,161, 0.81 ,21,38,49,108, 0.54 ,30,27,25,82, 0.41 ,47,32,27,106, 0.53 ,59,39,36,134, 0.67 ,65,33,36,134, 0.67 ,725, 0.60 ,auditory,3,Practice regularly
ST-926,95,25,120, 0.60 ,26,48,48,122, 0.61 ,52,47,78,177, 0.89 ,31,34,35,100, 0.50 ,69,34,30,133, 0.67 ,20,76,35,131, 0.66 ,783, 0.65 ,kinesthetic,4,Join study group
ST-927,21,32,53, 0.27 ,26,25,22,73, 0.37 ,42,49,52,143, 0.72 ,40,71,26,137, 0.69 ,49,44,28,121, 0.61 ,38,33,23,94, 0.47 ,621, 0.52 ,kinesthetic,2,Practice regularly
ST-928,67,80,147, 0.74 ,32,78,64,174, 0.87 ,55,49,29,133, 0.67 ,46,28,32,106, 0.53 ,76,72,34,182, 0.91 ,51,66,26,143, 0.72 ,885, 0.74 ,visual,1,Ask questions
ST-929,72,37,109, 0.55 ,41,67,56,164, 0.82 ,45,65,51,161, 0.81 ,21,54,37,112, 0.56 ,28,32,29,89, 0.45 ,33,28,23,84, 0.42 ,719, 0.60 ,visual,5,Ask questions
ST-930,52,40,92, 0.46 ,24,24,56,104, 0.52 ,55,76,39,170, 0.85 ,50,54,28,132, 0.66 ,29,72,27,128, 0.64 ,75,31,24,130, 0.65 ,756, 0.63 ,visual,3,Practice regularly
ST-931,40,42,82, 0.41 ,50,39,57,146, 0.73 ,42,66,22,130, 0.65 ,55,26,36,117, 0.59 ,30,70,24,124, 0.62 ,65,60,27,152, 0.76 ,751, 0.63 ,kinesthetic,1,Join study group
ST-932,89,37,126, 0.63 ,21,34,64,119, 0.60 ,27,51,56,134, 0.67 ,63,22,27,112, 0.56 ,38,40,23,101, 0.51 ,46,58,28,132, 0.66 ,724, 0.60 ,auditory,4,Join study group
ST-933,51,35,86, 0.43 ,22,77,33,132, 0.66 ,42,66,76,184, 0.92 ,77,34,24,135, 0.68 ,34,68,32,134, 0.67 ,48,22,28,98, 0.49 ,769, 0.64 ,visual,3,Practice regularly
ST-934,69,85,154, 0.77 ,25,33,35,93, 0.47 ,38,34,20,92, 0.46 ,52,26,36,114, 0.57 ,53,37,23,113, 0.57 ,79,78,28,185, 0.93 ,751, 0.63 ,auditory,2,Study more
ST-935,93,78,171, 0.86 ,26,66,58,150, 0.75 ,27,29,46,102, 0.51 ,35,67,26,128, 0.64 ,59,56,35,150, 0.75 ,70,67,37,174, 0.87 ,875, 0.73 ,visual,2,Practice regularly
ST-936,30,73,103, 0.52 ,59,40,39,138, 0.69 ,29,27,40,96, 0.48 ,59,46,28,133, 0.67 ,20,69,33,122, 0.61 ,37,63,31,131, 0.66 ,723, 0.60 ,auditory,4,Ask questions
ST-937,38,79,117, 0.59 ,58,23,39,120, 0.60 ,47,41,65,153, 0.77 ,27,39,26,92, 0.46 ,78,74,36,188, 0.94 ,56,22,23,101, 0.51 ,771, 0.64 ,kinesthetic,1,Study more
ST-938,81,36,117, 0.59 ,43,35,38,116, 0.58 ,51,52,61,164, 0.82 ,56,49,37,142, 0.71 ,67,25,21,113, 0.57 ,55,39,39,133, 0.67 ,785, 0.65 ,auditory,3,Practice regularly
ST-939,28,43,71, 0.36 ,28,75,78,181, 0.91 ,29,57,33,119, 0.60 ,35,72,20,127, 0.64 ,36,52,34,122, 0.61 ,23,25,36,84, 0.42 ,704, 0.59 ,kinesthetic,1,Ask questions
ST-940,69,51,120, 0.60 ,45,41,56,142, 0.71 ,20,57,61,138, 0.69 ,43,21,27,91, 0.46 ,42,33,31,106, 0.53 ,55,35,23,113, 0.57 ,710, 0.59 ,auditory,1,Ask questions
ST-941,87,31,118, 0.59 ,45,75,22,142, 0.71 ,33,22,60,115, 0.58 ,46,56,28,130, 0.65 ,46,23,24,93, 0.47 ,76,43,23,142, 0.71 ,740, 0.62 ,kinesthetic,2,Ask questions
ST-942,39,38,77, 0.39 ,32,64,51,147, 0.74 ,27,73,68,168, 0.84 ,70,36,20,126, 0.63 ,59,79,32,170, 0.85 ,40,55,23,118, 0.59 ,806, 0.67 ,auditory,5,Ask questions
ST-943,20,60,80, 0.40 ,25,31,58,114, 0.57 ,54,55,67,176, 0.88 ,50,64,21,135, 0.68 ,73,39,31,143, 0.72 ,54,39,32,125, 0.63 ,773, 0.64 ,visual,5,Ask questions
ST-944,69,53,122, 0.61 ,56,37,76,169, 0.85 ,22,39,45,106, 0.53 ,36,23,33,92, 0.46 ,68,37,30,135, 0.68 ,58,76,26,160, 0.80 ,784, 0.65 ,auditory,3,Ask questions
ST-945,28,74,102, 0.51 ,37,70,64,171, 0.86 ,21,57,32,110, 0.55 ,60,20,21,101, 0.51 ,22,66,30,118, 0.59 ,45,65,21,131, 0.66 ,733, 0.61 ,auditory,5,Join study group
ST-946,82,56,138, 0.69 ,57,51,36,144, 0.72 ,50,76,64,190, 0.95 ,32,67,34,133, 0.67 ,27,68,32,127, 0.64 ,49,53,21,123, 0.62 ,855, 0.71 ,visual,1,Join study group
ST-947,81,33,114, 0.57 ,53,20,64,137, 0.69 ,48,65,57,170, 0.85 ,66,77,21,164, 0.82 ,78,34,25,137, 0.69 ,71,38,20,129, 0.65 ,851, 0.71 ,kinesthetic,1,Join study group
ST-948,47,38,85, 0.43 ,42,53,49,144, 0.72 ,57,48,27,132, 0.66 ,67,44,25,136, 0.68 ,74,36,22,132, 0.66 ,28,25,27,80, 0.40 ,709, 0.59 ,kinesthetic,5,Join study group
ST-949,66,66,132, 0.66 ,33,79,26,138, 0.69 ,33,31,28,92, 0.46 ,36,23,31,90, 0.45 ,47,36,35,118, 0.59 ,72,47,33,152, 0.76 ,722, 0.60 ,kinesthetic,1,Study more
ST-950,83,87,170, 0.85 ,42,26,62,130, 0.65 ,41,64,23,128, 0.64 ,53,52,35,140, 0.70 ,56,50,23,129, 0.65 ,50,37,28,115, 0.58 ,812, 0.68 ,auditory,4,Study more
ST-951,61,64,125, 0.63 ,47,66,27,140, 0.70 ,54,26,69,149, 0.75 ,20,35,33,88, 0.44 ,37,77,33,147, 0.74 ,41,51,35,127, 0.64 ,776, 0.65 ,kinesthetic,2,Join study group
ST-952,46,45,91, 0.46 ,53,71,41,165, 0.83 ,50,62,47,159, 0.80 ,21,64,34,119, 0.60 ,58,61,35,154, 0.77 ,71,59,36,166, 0.83 ,854, 0.71 ,visual,5,Join study group
ST-953,20,73,93, 0.47 ,26,68,31,125, 0.63 ,38,64,25,127, 0.64 ,61,31,30,122, 0.61 ,46,57,34,137, 0.69 ,51,23,34,108, 0.54 ,712, 0.59 ,kinesthetic,2,Join study group
ST-954,76,66,142, 0.71 ,54,62,24,140, 0.70 ,41,28,47,116, 0.58 ,26,22,29,77, 0.39 ,66,58,33,157, 0.79 ,47,67,35,149, 0.75 ,781, 0.65 ,kinesthetic,1,Practice regularly
ST-955,29,68,97, 0.49 ,20,60,36,116, 0.58 ,25,41,48,114, 0.57 ,38,72,33,143, 0.72 ,28,49,23,100, 0.50 ,76,31,37,144, 0.72 ,714, 0.60 ,kinesthetic,2,Join study group
ST-956,81,63,144, 0.72 ,33,61,27,121, 0.61 ,58,52,67,177, 0.89 ,49,62,20,131, 0.66 ,27,29,35,91, 0.46 ,68,36,22,126, 0.63 ,790, 0.66 ,kinesthetic,5,Ask questions
ST-957,26,37,63, 0.32 ,29,45,36,110, 0.55 ,40,20,69,129, 0.65 ,47,72,31,150, 0.75 ,37,65,27,129, 0.65 ,62,29,39,130, 0.65 ,711, 0.59 ,visual,4,Ask questions
ST-958,40,88,128, 0.64 ,20,70,79,169, 0.85 ,21,34,53,108, 0.54 ,27,21,33,81, 0.41 ,23,76,34,133, 0.67 ,53,79,37,169, 0.85 ,788, 0.66 ,auditory,2,Ask questions
ST-959,25,25,50, 0.25 ,45,44,57,146, 0.73 ,58,22,54,134, 0.67 ,73,43,36,152, 0.76 ,73,31,28,132, 0.66 ,50,54,37,141, 0.71 ,755, 0.63 ,kinesthetic,5,Join study group
ST-960,52,83,135, 0.68 ,38,58,50,146, 0.73 ,46,75,29,150, 0.75 ,54,41,34,129, 0.65 ,26,79,20,125, 0.63 ,34,23,22,79, 0.40 ,764, 0.64 ,auditory,3,Practice regularly
ST-961,88,66,154, 0.77 ,49,37,71,157, 0.79 ,36,73,57,166, 0.83 ,61,45,21,127, 0.64 ,74,59,30,163, 0.82 ,43,42,35,120, 0.60 ,887, 0.74 ,visual,3,Ask questions
ST-962,48,75,123, 0.62 ,31,62,73,166, 0.83 ,41,60,53,154, 0.77 ,65,79,22,166, 0.83 ,71,53,24,148, 0.74 ,73,55,27,155, 0.78 ,912, 0.76 ,kinesthetic,5,Study more
ST-963,69,53,122, 0.61 ,46,47,46,139, 0.70 ,30,44,53,127, 0.64 ,72,69,24,165, 0.83 ,42,30,37,109, 0.55 ,60,28,27,115, 0.58 ,777, 0.65 ,kinesthetic,2,Practice regularly
ST-964,65,80,145, 0.73 ,52,62,51,165, 0.83 ,46,65,38,149, 0.75 ,72,49,36,157, 0.79 ,44,62,34,140, 0.70 ,74,21,33,128, 0.64 ,884, 0.74 ,kinesthetic,2,Practice regularly
ST-965,75,73,148, 0.74 ,31,60,50,141, 0.71 ,56,63,43,162, 0.81 ,50,32,30,112, 0.56 ,70,78,30,178, 0.89 ,40,79,29,148, 0.74 ,889, 0.74 ,kinesthetic,3,Join study group
ST-966,70,50,120, 0.60 ,31,46,72,149, 0.75 ,56,30,55,141, 0.71 ,48,50,27,125, 0.63 ,71,67,26,164, 0.82 ,78,25,32,135, 0.68 ,834, 0.70 ,auditory,2,Join study group
ST-967,27,32,59, 0.30 ,51,38,75,164, 0.82 ,40,63,40,143, 0.72 ,32,75,30,137, 0.69 ,34,60,36,130, 0.65 ,37,62,20,119, 0.60 ,752, 0.63 ,visual,4,Ask questions
ST-968,89,93,182, 0.91 ,30,79,38,147, 0.74 ,44,50,75,169, 0.85 ,32,63,21,116, 0.58 ,61,30,29,120, 0.60 ,38,76,28,142, 0.71 ,876, 0.73 ,auditory,1,Join study group
ST-969,93,73,166, 0.83 ,56,31,62,149, 0.75 ,54,58,20,132, 0.66 ,40,36,30,106, 0.53 ,78,32,28,138, 0.69 ,63,68,29,160, 0.80 ,851, 0.71 ,auditory,2,Join study group
ST-970,61,27,88, 0.44 ,43,74,25,142, 0.71 ,27,30,50,107, 0.54 ,58,58,23,139, 0.70 ,21,43,39,103, 0.52 ,67,75,36,178, 0.89 ,757, 0.63 ,kinesthetic,4,Ask questions
ST-971,77,43,120, 0.60 ,22,69,73,164, 0.82 ,25,31,23,79, 0.40 ,54,73,25,152, 0.76 ,41,52,39,132, 0.66 ,36,69,36,141, 0.71 ,788, 0.66 ,auditory,5,Ask questions
ST-972,38,39,77, 0.39 ,30,70,61,161, 0.81 ,50,72,47,169, 0.85 ,26,73,24,123, 0.62 ,20,40,29,89, 0.45 ,74,74,33,181, 0.91 ,800, 0.67 ,auditory,1,Practice regularly
ST-973,93,51,144, 0.72 ,59,47,67,173, 0.87 ,46,48,41,135, 0.68 ,37,64,32,133, 0.67 ,52,29,38,119, 0.60 ,78,67,25,170, 0.85 ,874, 0.73 ,kinesthetic,5,Practice regularly
ST-974,78,53,131, 0.66 ,20,44,44,108, 0.54 ,24,24,38,86, 0.43 ,77,42,24,143, 0.72 ,33,56,33,122, 0.61 ,49,72,28,149, 0.75 ,739, 0.62 ,kinesthetic,2,Study more
ST-975,54,65,119, 0.60 ,46,74,61,181, 0.91 ,45,58,49,152, 0.76 ,34,30,20,84, 0.42 ,30,33,24,87, 0.44 ,68,78,28,174, 0.87 ,797, 0.66 ,auditory,5,Practice regularly
ST-976,80,97,177, 0.89 ,28,72,65,165, 0.83 ,45,57,41,143, 0.72 ,21,73,24,118, 0.59 ,22,68,24,114, 0.57 ,42,26,39,107, 0.54 ,824, 0.69 ,visual,1,Study more
ST-977,32,35,67, 0.34 ,54,73,27,154, 0.77 ,59,28,29,116, 0.58 ,62,70,27,159, 0.80 ,71,75,39,185, 0.93 ,52,73,35,160, 0.80 ,841, 0.70 ,visual,3,Practice regularly
ST-978,91,56,147, 0.74 ,26,59,56,141, 0.71 ,22,56,33,111, 0.56 ,63,77,31,171, 0.86 ,40,78,21,139, 0.70 ,57,63,20,140, 0.70 ,849, 0.71 ,auditory,4,Practice regularly
ST-979,63,26,89, 0.45 ,45,50,55,150, 0.75 ,40,47,67,154, 0.77 ,50,46,24,120, 0.60 ,79,32,34,145, 0.73 ,31,68,21,120, 0.60 ,778, 0.65 ,kinesthetic,2,Study more
ST-980,67,41,108, 0.54 ,21,55,24,100, 0.50 ,38,65,72,175, 0.88 ,55,36,34,125, 0.63 ,64,77,29,170, 0.85 ,62,48,33,143, 0.72 ,821, 0.68 ,auditory,1,Study more
ST-981,32,39,71, 0.36 ,43,46,56,145, 0.73 ,38,68,61,167, 0.84 ,32,77,33,142, 0.71 ,52,29,24,105, 0.53 ,37,78,28,143, 0.72 ,773, 0.64 ,kinesthetic,3,Study more
ST-982,37,61,98, 0.49 ,40,43,26,109, 0.55 ,57,22,26,105, 0.53 ,53,48,26,127, 0.64 ,48,29,34,111, 0.56 ,40,55,28,123, 0.62 ,673, 0.56 ,auditory,3,Ask questions
ST-983,53,63,116, 0.58 ,27,48,71,146, 0.73 ,35,51,42,128, 0.64 ,57,26,32,115, 0.58 ,79,53,36,168, 0.84 ,46,21,35,102, 0.51 ,775, 0.65 ,visual,5,Ask questions
ST-984,56,71,127, 0.64 ,40,68,40,148, 0.74 ,39,36,62,137, 0.69 ,65,30,24,119, 0.60 ,22,39,27,88, 0.44 ,76,35,39,150, 0.75 ,769, 0.64 ,visual,5,Join study group
ST-985,88,59,147, 0.74 ,58,53,59,170, 0.85 ,59,69,54,182, 0.91 ,20,68,34,122, 0.61 ,75,70,35,180, 0.90 ,55,72,26,153, 0.77 ,954, 0.80 ,visual,3,Practice regularly
ST-986,93,27,120, 0.60 ,37,64,45,146, 0.73 ,27,68,37,132, 0.66 ,28,58,24,110, 0.55 ,30,28,29,87, 0.44 ,71,69,36,176, 0.88 ,771, 0.64 ,auditory,5,Study more
ST-987,77,55,132, 0.66 ,44,33,68,145, 0.73 ,34,42,55,131, 0.66 ,31,20,34,85, 0.43 ,75,64,29,168, 0.84 ,79,28,39,146, 0.73 ,807, 0.67 ,kinesthetic,5,Join study group
ST-988,84,93,177, 0.89 ,31,73,40,144, 0.72 ,58,22,78,158, 0.79 ,39,23,38,100, 0.50 ,24,35,27,86, 0.43 ,22,48,34,104, 0.52 ,769, 0.64 ,auditory,5,Ask questions
ST-989,59,60,119, 0.60 ,21,63,54,138, 0.69 ,41,70,26,137, 0.69 ,65,20,34,119, 0.60 ,59,73,26,158, 0.79 ,66,28,33,127, 0.64 ,798, 0.67 ,auditory,3,Join study group
ST-990,60,96,156, 0.78 ,26,74,55,155, 0.78 ,29,37,34,100, 0.50 ,59,79,23,161, 0.81 ,52,69,26,147, 0.74 ,60,34,38,132, 0.66 ,851, 0.71 ,auditory,3,Join study group
ST-991,82,42,124, 0.62 ,39,61,49,149, 0.75 ,40,41,52,133, 0.67 ,25,53,28,106, 0.53 ,45,43,35,123, 0.62 ,51,42,30,123, 0.62 ,758, 0.63 ,visual,3,Ask questions
ST-992,89,72,161, 0.81 ,37,49,22,108, 0.54 ,46,37,52,135, 0.68 ,72,63,27,162, 0.81 ,29,42,36,107, 0.54 ,48,72,35,155, 0.78 ,828, 0.69 ,visual,5,Study more
ST-993,77,58,135, 0.68 ,20,53,28,101, 0.51 ,26,76,78,180, 0.90 ,36,66,36,138, 0.69 ,64,59,28,151, 0.76 ,79,38,22,139, 0.70 ,844, 0.70 ,visual,2,Join study group
ST-994,47,25,72, 0.36 ,36,33,45,114, 0.57 ,33,77,41,151, 0.76 ,28,38,28,94, 0.47 ,71,24,37,132, 0.66 ,41,30,30,101, 0.51 ,664, 0.55 ,auditory,5,Practice regularly
ST-995,41,80,121, 0.61 ,43,45,21,109, 0.55 ,26,25,35,86, 0.43 ,49,68,31,148, 0.74 ,27,24,21,72, 0.36 ,24,62,38,124, 0.62 ,660, 0.55 ,kinesthetic,5,Study more
ST-996,38,66,104, 0.52 ,30,61,48,139, 0.70 ,22,29,78,129, 0.65 ,49,31,24,104, 0.52 ,58,31,30,119, 0.60 ,72,52,22,146, 0.73 ,741, 0.62 ,auditory,3,Ask questions
ST-997,38,50,88, 0.44 ,57,65,64,186, 0.93 ,25,47,67,139, 0.70 ,21,70,33,124, 0.62 ,38,51,21,110, 0.55 ,78,57,35,170, 0.85 ,817, 0.68 ,visual,2,Study more
ST-998,91,50,141, 0.71 ,20,48,49,117, 0.59 ,23,51,36,110, 0.55 ,56,23,20,99, 0.50 ,59,75,26,160, 0.80 ,56,64,39,159, 0.80 ,786, 0.66 ,auditory,3,Ask questions
ST-999,20,32,52, 0.26 ,37,43,31,111, 0.56 ,41,21,74,136, 0.68 ,34,23,24,81, 0.41 ,64,74,20,158, 0.79 ,23,57,32,112, 0.56 ,650, 0.54 ,auditory,3,Practice regularly
ST-1000,26,92,118, 0.59 ,21,66,50,137, 0.69 ,42,23,71,136, 0.68 ,75,65,32,172, 0.86 ,52,38,31,121, 0.61 ,36,38,32,106, 0.53 ,790, 0.66 ,auditory,2,Ask questions
