student_id,math_p1,math_p2,Total_Math,percentange_maths,eng_p1,eng_p2,eng_p3,Total_english,English_Percentage,kisw_p1,kisw_p2,kisw_p3,Total_marks_swahili,Kiswahili_Percentage,chem_p1,chem_p2,chem_p3,Total_Chem,Chem_Percentage,bio_p1,bio_p2,bio_p3,Total Bio,Bology_Percentage,phy_p1,phy_p2,phy_p3,Total_Phy,Physics_Percentage,Total_marks,Total_percentage,learning_style,self_assessment,recommendations
ST-001,83,73,156,78%,33,75,60,168,84%,57,52,25,134,67%,76,38,28,142,71%,63,47,33,143,72%,49,60,31,140,70%,883,74%,kinesthetic,2,Join study group
ST-002,98,51,149,75%,22,65,57,144,72%,23,69,55,147,74%,20,52,20,92,46%,28,59,30,117,59%,20,40,25,85,43%,734,61%,kinesthetic,2,Study more
ST-003,47,62,109,55%,53,46,45,144,72%,30,63,56,149,75%,33,30,27,90,45%,64,66,21,151,76%,36,33,38,107,54%,750,63%,kinesthetic,1,Practice regularly
ST-004,23,21,44,22%,28,58,63,149,75%,29,20,33,82,41%,66,57,39,162,81%,52,56,33,141,71%,56,55,38,149,75%,727,61%,auditory,3,Ask questions
ST-005,45,24,69,35%,36,38,78,152,76%,35,59,57,151,76%,34,61,33,128,64%,53,37,28,118,59%,77,37,27,141,71%,759,63%,kinesthetic,5,Study more
ST-006,66,49,115,58%,40,48,70,158,79%,40,38,47,125,63%,32,22,28,82,41%,44,61,26,131,66%,27,65,24,116,58%,727,61%,visual,2,Join study group
ST-007,80,71,151,76%,22,36,63,121,61%,33,60,40,133,67%,78,40,35,153,77%,58,70,36,164,82%,33,73,22,128,64%,850,71%,kinesthetic,3,Join study group
ST-008,49,89,138,69%,58,42,77,177,89%,27,60,25,112,56%,22,59,36,117,59%,43,20,31,94,47%,42,25,28,95,48%,733,61%,kinesthetic,2,Join study group
ST-009,89,21,110,55%,33,34,44,111,56%,47,31,64,142,71%,48,42,25,115,58%,61,23,27,111,56%,65,27,30,122,61%,711,59%,visual,3,Practice regularly
ST-010,86,68,154,77%,25,76,78,179,90%,26,79,44,149,75%,37,50,38,125,63%,31,66,37,134,67%,68,63,35,166,83%,907,76%,visual,3,Study more
ST-011,87,40,127,64%,48,62,45,155,78%,22,25,53,100,50%,47,68,37,152,76%,44,77,22,143,72%,67,20,37,124,62%,801,67%,auditory,4,Study more
ST-012,68,51,119,60%,32,68,34,134,67%,49,78,22,149,75%,59,55,25,139,70%,25,40,31,96,48%,56,53,26,135,68%,772,64%,visual,3,Practice regularly
ST-013,82,82,164,82%,35,27,22,84,42%,52,67,53,172,86%,62,23,36,121,61%,35,64,37,136,68%,68,42,31,141,71%,818,68%,visual,3,Study more
ST-014,81,40,121,61%,37,30,23,90,45%,45,77,52,174,87%,73,62,34,169,85%,76,71,37,184,92%,61,64,25,150,75%,888,74%,kinesthetic,3,Study more
ST-015,62,74,136,68%,37,67,49,153,77%,55,35,23,113,57%,33,29,26,88,44%,79,75,28,182,91%,71,36,39,146,73%,818,68%,kinesthetic,1,Study more
ST-016,35,93,128,64%,26,67,43,136,68%,56,22,70,148,74%,76,32,27,135,68%,26,74,30,130,65%,29,28,26,83,42%,760,63%,kinesthetic,1,Study more
ST-017,93,63,156,78%,48,78,44,170,85%,57,60,60,177,89%,23,44,21,88,44%,70,76,21,167,84%,76,34,23,133,67%,891,74%,kinesthetic,2,Ask questions
ST-018,65,97,162,81%,23,27,73,123,62%,32,66,29,127,64%,58,64,21,143,72%,29,56,30,115,58%,35,37,26,98,49%,768,64%,visual,5,Join study group
ST-019,37,97,134,67%,38,65,46,149,75%,57,69,32,158,79%,21,43,30,94,47%,23,22,38,83,42%,63,77,27,167,84%,785,65%,visual,2,Study more
ST-020,69,37,106,53%,58,44,75,177,89%,24,35,79,138,69%,44,26,27,97,49%,61,52,39,152,76%,66,56,37,159,80%,829,69%,kinesthetic,3,Ask questions
ST-021,20,52,72,36%,45,61,62,168,84%,28,70,37,135,68%,63,35,27,125,63%,31,44,39,114,57%,34,22,33,89,45%,703,59%,kinesthetic,3,Practice regularly
ST-022,28,81,109,55%,24,69,23,116,58%,51,70,74,195,98%,32,25,39,96,48%,69,76,31,176,88%,66,33,20,119,60%,811,68%,auditory,2,Join study group
ST-023,34,99,133,67%,53,32,71,156,78%,35,57,72,164,82%,33,55,23,111,56%,68,79,24,171,86%,69,25,34,128,64%,863,72%,auditory,2,Study more
ST-024,29,97,126,63%,40,57,54,151,76%,48,62,64,174,87%,36,63,28,127,64%,69,35,30,134,67%,70,66,30,166,83%,878,73%,kinesthetic,4,Practice regularly
ST-025,43,37,80,40%,43,73,66,182,91%,27,20,44,91,46%,46,58,37,141,71%,59,76,27,162,81%,49,78,36,163,82%,819,68%,kinesthetic,3,Study more
ST-026,90,91,181,91%,31,44,47,122,61%,28,42,63,133,67%,50,43,20,113,57%,49,30,28,107,54%,29,33,27,89,45%,745,62%,visual,3,Study more
ST-027,72,90,162,81%,30,48,67,145,73%,59,51,65,175,88%,60,57,33,150,75%,22,28,31,81,41%,28,66,29,123,62%,836,70%,auditory,5,Practice regularly
ST-028,32,21,53,27%,48,65,64,177,89%,59,25,30,114,57%,40,46,22,108,54%,68,54,31,153,77%,56,44,31,131,66%,736,61%,auditory,2,Study more
ST-029,61,80,141,71%,50,41,65,156,78%,50,47,31,128,64%,54,20,35,109,55%,70,28,37,135,68%,33,69,21,123,62%,792,66%,visual,5,Practice regularly
ST-030,33,29,62,31%,24,60,30,114,57%,43,74,26,143,72%,42,45,31,118,59%,52,42,34,128,64%,41,40,23,104,52%,669,56%,auditory,5,Practice regularly
ST-031,63,87,150,75%,54,53,38,145,73%,43,65,31,139,70%,33,20,25,78,39%,44,20,28,92,46%,45,51,37,133,67%,737,61%,visual,4,Practice regularly
ST-032,45,83,128,64%,47,50,49,146,73%,40,74,71,185,93%,28,67,34,129,65%,62,55,33,150,75%,76,20,38,134,67%,872,73%,kinesthetic,5,Study more
ST-033,66,94,160,80%,54,52,62,168,84%,25,43,38,106,53%,73,60,36,169,85%,62,59,28,149,75%,62,41,31,134,67%,886,74%,auditory,3,Ask questions
ST-034,69,28,97,49%,55,61,57,173,87%,27,56,41,124,62%,22,66,20,108,54%,47,44,20,111,56%,21,27,39,87,44%,700,58%,auditory,1,Study more
ST-035,22,85,107,54%,54,48,28,130,65%,56,22,66,144,72%,23,43,32,98,49%,44,34,36,114,57%,74,35,37,146,73%,739,62%,auditory,3,Study more
ST-036,82,48,130,65%,58,67,57,182,91%,24,39,31,94,47%,40,42,30,112,56%,59,26,27,112,56%,36,65,31,132,66%,762,64%,kinesthetic,3,Practice regularly
ST-037,54,57,111,56%,47,29,75,151,76%,26,40,72,138,69%,27,39,32,98,49%,37,35,21,93,47%,77,38,36,151,76%,742,62%,visual,2,Ask questions
ST-038,82,85,167,84%,44,59,47,150,75%,58,60,51,169,85%,24,52,35,111,56%,31,33,38,102,51%,79,50,24,153,77%,852,71%,auditory,5,Study more
ST-039,39,37,76,38%,41,40,75,156,78%,22,21,40,83,42%,79,45,35,159,80%,73,74,21,168,84%,30,75,39,144,72%,786,66%,visual,1,Join study group
ST-040,29,89,118,59%,20,38,63,121,61%,26,37,61,124,62%,67,28,26,121,61%,67,26,32,125,63%,33,54,38,125,63%,734,61%,kinesthetic,3,Practice regularly
ST-041,60,96,156,78%,52,45,70,167,84%,27,63,32,122,61%,34,70,20,124,62%,53,69,35,157,79%,74,55,37,166,83%,892,74%,kinesthetic,3,Practice regularly
ST-042,33,20,53,27%,23,36,78,137,69%,37,22,24,83,42%,22,66,25,113,57%,28,78,29,135,68%,46,65,26,137,69%,658,55%,visual,5,Study more
ST-043,82,31,113,57%,45,72,36,153,77%,33,62,26,121,61%,75,79,20,174,87%,61,24,27,112,56%,40,28,24,92,46%,765,64%,visual,1,Study more
ST-044,72,84,156,78%,39,58,49,146,73%,35,45,22,102,51%,64,57,21,142,71%,57,36,30,123,62%,31,53,28,112,56%,781,65%,visual,4,Practice regularly
ST-045,58,49,107,54%,40,44,21,105,53%,57,46,77,180,90%,38,62,23,123,62%,22,73,28,123,62%,22,48,32,102,51%,740,62%,auditory,1,Study more
ST-046,46,93,139,70%,36,63,46,145,73%,57,23,50,130,65%,35,22,27,84,42%,33,78,24,135,68%,28,22,26,76,38%,709,59%,auditory,2,Join study group
ST-047,86,67,153,77%,54,23,62,139,70%,27,68,56,151,76%,66,51,35,152,76%,43,68,21,132,66%,21,69,23,113,57%,840,70%,auditory,1,Ask questions
ST-048,59,76,135,68%,22,45,33,100,50%,27,30,44,101,51%,55,77,22,154,77%,51,29,35,115,58%,67,21,38,126,63%,731,61%,kinesthetic,2,Join study group
ST-049,96,62,158,79%,56,23,75,154,77%,37,75,39,151,76%,70,49,27,146,73%,25,71,37,133,67%,61,52,24,137,69%,879,73%,auditory,4,Practice regularly
ST-050,21,27,48,24%,41,31,78,150,75%,41,24,25,90,45%,65,66,23,154,77%,37,69,25,131,66%,59,24,36,119,60%,692,58%,auditory,2,Ask questions
ST-051,93,44,137,69%,42,65,78,185,93%,20,34,47,101,51%,34,68,31,133,67%,43,45,26,114,57%,72,44,33,149,75%,819,68%,kinesthetic,4,Practice regularly
ST-052,32,22,54,27%,55,38,52,145,73%,58,51,58,167,84%,63,26,22,111,56%,23,56,33,112,56%,46,28,32,106,53%,695,58%,visual,3,Practice regularly
ST-053,44,82,126,63%,54,27,29,110,55%,57,71,59,187,94%,20,25,30,75,38%,75,52,35,162,81%,36,73,25,134,67%,794,66%,kinesthetic,4,Practice regularly
ST-054,26,90,116,58%,32,22,68,122,61%,56,66,58,180,90%,22,22,26,70,35%,55,23,25,103,52%,60,74,29,163,82%,754,63%,auditory,5,Practice regularly
ST-055,65,95,160,80%,31,72,77,180,90%,29,75,52,156,78%,22,47,26,95,48%,66,48,39,153,77%,67,47,26,140,70%,884,74%,kinesthetic,2,Join study group
ST-056,77,63,140,70%,39,32,47,118,59%,52,25,50,127,64%,32,53,23,108,54%,38,61,30,129,65%,38,42,27,107,54%,729,61%,kinesthetic,1,Join study group
ST-057,36,39,75,38%,54,34,38,126,63%,59,22,39,120,60%,68,71,24,163,82%,21,69,38,128,64%,77,49,25,151,76%,763,64%,kinesthetic,5,Ask questions
ST-058,25,25,50,25%,37,30,49,116,58%,40,71,69,180,90%,73,74,30,177,89%,66,29,25,120,60%,23,54,34,111,56%,754,63%,auditory,5,Ask questions
ST-059,37,89,126,63%,55,57,24,136,68%,55,64,41,160,80%,38,76,29,143,72%,72,59,28,159,80%,24,24,38,86,43%,810,68%,kinesthetic,2,Join study group
ST-060,91,86,177,89%,46,22,58,126,63%,52,37,32,121,61%,20,41,22,83,42%,41,73,36,150,75%,63,21,34,118,59%,775,65%,kinesthetic,3,Study more
ST-061,30,53,83,42%,47,35,54,136,68%,24,56,63,143,72%,40,48,38,126,63%,76,51,38,165,83%,52,25,24,101,51%,754,63%,visual,3,Study more
ST-062,88,85,173,87%,28,64,60,152,76%,46,53,54,153,77%,31,35,27,93,47%,79,56,22,157,79%,55,53,29,137,69%,865,72%,auditory,1,Ask questions
ST-063,88,32,120,60%,50,51,64,165,83%,54,65,70,189,95%,21,40,35,96,48%,49,54,31,134,67%,37,48,25,110,55%,814,68%,visual,5,Join study group
ST-064,38,87,125,63%,26,41,30,97,49%,53,75,68,196,98%,26,37,31,94,47%,69,46,31,146,73%,27,63,36,126,63%,784,65%,kinesthetic,1,Practice regularly
ST-065,98,69,167,84%,36,29,79,144,72%,55,45,65,165,83%,62,39,36,137,69%,41,77,30,148,74%,28,66,24,118,59%,879,73%,kinesthetic,1,Ask questions
ST-066,73,57,130,65%,54,49,68,171,86%,44,70,43,157,79%,38,65,22,125,63%,50,70,26,146,73%,76,58,33,167,84%,896,75%,kinesthetic,3,Ask questions
ST-067,49,98,147,74%,31,73,79,183,92%,34,61,75,170,85%,73,28,23,124,62%,63,56,35,154,77%,72,78,28,178,89%,956,80%,kinesthetic,2,Join study group
ST-068,83,66,149,75%,47,67,73,187,94%,41,63,40,144,72%,63,67,39,169,85%,75,68,31,174,87%,55,48,25,128,64%,951,79%,kinesthetic,1,Practice regularly
ST-069,82,97,179,90%,36,59,63,158,79%,57,29,22,108,54%,48,66,34,148,74%,75,51,32,158,79%,33,76,20,129,65%,880,73%,visual,5,Join study group
ST-070,53,73,126,63%,59,78,36,173,87%,34,77,35,146,73%,57,62,38,157,79%,62,23,21,106,53%,37,34,37,108,54%,816,68%,kinesthetic,3,Join study group
ST-071,64,47,111,56%,53,67,72,192,96%,21,24,59,104,52%,54,52,39,145,73%,57,69,36,162,81%,65,22,36,123,62%,837,70%,visual,5,Study more
ST-072,79,20,99,50%,33,29,60,122,61%,56,45,27,128,64%,49,58,30,137,69%,29,37,24,90,45%,45,32,39,116,58%,692,58%,visual,5,Study more
ST-073,82,63,145,73%,35,50,68,153,77%,26,24,75,125,63%,28,70,32,130,65%,68,26,28,122,61%,22,51,22,95,48%,770,64%,visual,3,Ask questions
ST-074,63,22,85,43%,50,64,78,192,96%,45,69,46,160,80%,36,61,38,135,68%,33,67,35,135,68%,48,73,35,156,78%,863,72%,auditory,2,Ask questions
ST-075,84,23,107,54%,45,74,33,152,76%,28,35,29,92,46%,49,60,23,132,66%,75,44,32,151,76%,46,72,24,142,71%,776,65%,kinesthetic,4,Study more
ST-076,95,57,152,76%,29,29,31,89,45%,26,27,67,120,60%,33,49,31,113,57%,27,20,27,74,37%,41,34,27,102,51%,650,54%,kinesthetic,5,Study more
ST-077,37,30,67,34%,36,36,75,147,74%,40,57,52,149,75%,60,67,36,163,82%,71,42,35,148,74%,45,49,21,115,58%,789,66%,auditory,5,Join study group
ST-078,52,89,141,71%,34,46,73,153,77%,56,31,62,149,75%,78,70,20,168,84%,52,55,36,143,72%,79,67,37,183,92%,937,78%,visual,2,Practice regularly
ST-079,99,35,134,67%,55,48,70,173,87%,45,44,61,150,75%,38,73,31,142,71%,73,65,31,169,85%,48,42,37,127,64%,895,75%,visual,3,Ask questions
ST-080,92,98,190,95%,49,66,41,156,78%,54,30,76,160,80%,48,28,38,114,57%,33,63,26,122,61%,71,67,31,169,85%,911,76%,auditory,1,Study more
ST-081,81,69,150,75%,31,35,35,101,51%,57,32,62,151,76%,25,26,30,81,41%,54,26,39,119,60%,68,76,35,179,90%,781,65%,auditory,3,Practice regularly
ST-082,76,36,112,56%,28,74,76,178,89%,53,68,72,193,97%,71,53,21,145,73%,34,33,25,92,46%,66,69,30,165,83%,885,74%,visual,3,Practice regularly
ST-083,57,94,151,76%,34,68,46,148,74%,38,72,69,179,90%,52,23,20,95,48%,69,26,33,128,64%,48,20,23,91,46%,792,66%,visual,2,Practice regularly
ST-084,88,97,185,93%,22,76,23,121,61%,36,36,58,130,65%,53,65,27,145,73%,63,56,29,148,74%,50,42,28,120,60%,849,71%,auditory,1,Join study group
ST-085,66,68,134,67%,38,73,26,137,69%,42,22,76,140,70%,77,36,28,141,71%,44,20,35,99,50%,24,24,34,82,41%,733,61%,auditory,4,Ask questions
ST-086,25,23,48,24%,54,26,79,159,80%,41,76,73,190,95%,32,42,37,111,56%,66,39,26,131,66%,79,39,35,153,77%,792,66%,visual,3,Join study group
ST-087,99,36,135,68%,59,53,39,151,76%,25,20,23,68,34%,59,45,29,133,67%,46,68,26,140,70%,68,40,32,140,70%,767,64%,kinesthetic,1,Ask questions
ST-088,52,24,76,38%,42,40,27,109,55%,43,79,51,173,87%,48,23,28,99,50%,77,60,23,160,80%,64,57,23,144,72%,761,63%,auditory,2,Ask questions
ST-089,40,61,101,51%,25,55,72,152,76%,31,38,34,103,52%,38,52,24,114,57%,23,74,31,128,64%,70,70,20,160,80%,758,63%,kinesthetic,3,Practice regularly
ST-090,74,92,166,83%,37,56,54,147,74%,37,41,45,123,62%,55,68,28,151,76%,20,32,31,83,42%,26,67,38,131,66%,801,67%,auditory,2,Ask questions
ST-091,47,40,87,44%,52,37,46,135,68%,29,45,43,117,59%,73,47,36,156,78%,75,64,37,176,88%,26,35,39,100,50%,771,64%,visual,2,Practice regularly
ST-092,28,97,125,63%,25,37,41,103,52%,48,24,49,121,61%,37,74,21,132,66%,71,40,22,133,67%,33,58,34,125,63%,739,62%,kinesthetic,4,Study more
ST-093,26,84,110,55%,58,28,52,138,69%,49,58,38,145,73%,23,48,25,96,48%,54,68,38,160,80%,28,45,28,101,51%,750,63%,kinesthetic,4,Join study group
ST-094,36,26,62,31%,42,21,48,111,56%,58,33,23,114,57%,37,59,36,132,66%,42,45,39,126,63%,36,54,33,123,62%,668,56%,visual,3,Study more
ST-095,66,52,118,59%,43,64,48,155,78%,50,75,60,185,93%,56,70,20,146,73%,51,77,25,153,77%,23,79,37,139,70%,896,75%,kinesthetic,1,Practice regularly
ST-096,45,80,125,63%,50,49,48,147,74%,51,52,37,140,70%,27,29,24,80,40%,40,64,25,129,65%,66,77,22,165,83%,786,66%,kinesthetic,4,Join study group
ST-097,88,71,159,80%,35,78,63,176,88%,47,30,75,152,76%,54,69,22,145,73%,35,39,24,98,49%,49,37,28,114,57%,844,70%,auditory,5,Practice regularly
ST-098,98,87,185,93%,42,76,63,181,91%,40,26,70,136,68%,27,68,31,126,63%,75,53,22,150,75%,52,27,29,108,54%,886,74%,kinesthetic,3,Ask questions
ST-099,37,75,112,56%,42,59,72,173,87%,38,62,69,169,85%,43,59,24,126,63%,54,58,25,137,69%,53,42,28,123,62%,840,70%,auditory,5,Study more
ST-100,82,57,139,70%,56,69,29,154,77%,36,42,67,145,73%,65,21,29,115,58%,73,79,31,183,92%,52,42,24,118,59%,854,71%,visual,4,Ask questions
ST-101,46,67,113,57%,54,36,51,141,71%,24,55,38,117,59%,54,41,22,117,59%,68,68,24,160,80%,76,22,22,120,60%,768,64%,kinesthetic,2,Ask questions
ST-102,25,30,55,28%,24,38,43,105,53%,47,56,36,139,70%,54,37,24,115,58%,50,56,33,139,70%,58,56,24,138,69%,691,58%,visual,5,Ask questions
ST-103,41,50,91,46%,42,38,31,111,56%,37,39,35,111,56%,48,54,22,124,62%,68,47,28,143,72%,27,57,23,107,54%,687,57%,auditory,5,Study more
ST-104,61,92,153,77%,33,75,53,161,81%,32,62,26,120,60%,51,54,30,135,68%,31,57,31,119,60%,49,44,31,124,62%,812,68%,auditory,4,Study more
ST-105,28,57,85,43%,46,79,22,147,74%,25,36,76,137,69%,36,60,32,128,64%,64,75,28,167,84%,57,51,37,145,73%,809,67%,kinesthetic,4,Ask questions
ST-106,22,32,54,27%,45,20,36,101,51%,24,31,22,77,39%,23,38,26,87,44%,59,63,27,149,75%,43,46,37,126,63%,594,50%,visual,2,Ask questions
ST-107,68,72,140,70%,31,77,67,175,88%,41,32,47,120,60%,31,67,35,133,67%,74,48,30,152,76%,21,77,20,118,59%,838,70%,visual,4,Practice regularly
ST-108,49,51,100,50%,32,62,65,159,80%,53,30,72,155,78%,33,32,24,89,45%,49,56,24,129,65%,44,74,21,139,70%,771,64%,visual,2,Practice regularly
ST-109,36,65,101,51%,33,59,26,118,59%,48,20,35,103,52%,28,54,25,107,54%,65,71,26,162,81%,79,79,34,192,96%,783,65%,kinesthetic,5,Ask questions
ST-110,27,31,58,29%,28,56,67,151,76%,51,22,23,96,48%,36,26,30,92,46%,40,28,29,97,49%,46,52,34,132,66%,626,52%,auditory,3,Ask questions
ST-111,34,23,57,29%,29,28,28,85,43%,48,71,75,194,97%,62,21,22,105,53%,72,30,39,141,71%,72,57,28,157,79%,739,62%,kinesthetic,1,Practice regularly
ST-112,20,85,105,53%,36,78,35,149,75%,29,35,38,102,51%,50,61,25,136,68%,60,51,34,145,73%,38,73,29,140,70%,777,65%,visual,3,Practice regularly
ST-113,32,26,58,29%,29,63,79,171,86%,59,31,58,148,74%,64,67,26,157,79%,69,58,26,153,77%,79,65,37,181,91%,868,72%,auditory,5,Study more
ST-114,99,44,143,72%,37,29,33,99,50%,20,58,40,118,59%,32,31,34,97,49%,62,56,28,146,73%,47,23,24,94,47%,697,58%,kinesthetic,1,Practice regularly
ST-115,72,23,95,48%,53,45,59,157,79%,21,56,47,124,62%,69,47,36,152,76%,24,77,31,132,66%,38,36,36,110,55%,770,64%,visual,1,Ask questions
ST-116,70,32,102,51%,47,74,26,147,74%,53,44,40,137,69%,78,60,30,168,84%,49,76,34,159,80%,52,56,29,137,69%,850,71%,visual,1,Join study group
ST-117,89,69,158,79%,43,25,41,109,55%,55,57,72,184,92%,73,54,24,151,76%,26,36,25,87,44%,33,33,37,103,52%,792,66%,visual,3,Practice regularly
ST-118,69,69,138,69%,26,73,66,165,83%,52,71,61,184,92%,72,24,30,126,63%,65,26,25,116,58%,20,76,35,131,66%,860,72%,kinesthetic,4,Practice regularly
ST-119,95,59,154,77%,34,69,37,140,70%,58,47,59,164,82%,43,39,29,111,56%,48,70,33,151,76%,41,69,32,142,71%,862,72%,visual,1,Study more
ST-120,93,24,117,59%,44,72,57,173,87%,37,35,29,101,51%,38,63,33,134,67%,31,46,23,100,50%,48,23,39,110,55%,735,61%,visual,1,Ask questions
ST-121,70,31,101,51%,48,50,36,134,67%,24,33,49,106,53%,26,46,23,95,48%,51,38,24,113,57%,69,38,21,128,64%,677,56%,kinesthetic,1,Practice regularly
ST-122,61,94,155,78%,55,29,30,114,57%,46,20,36,102,51%,29,30,23,82,41%,39,50,30,119,60%,64,56,34,154,77%,726,61%,kinesthetic,4,Join study group
ST-123,30,36,66,33%,58,37,76,171,86%,41,68,51,160,80%,28,71,36,135,68%,65,36,27,128,64%,43,51,28,122,61%,782,65%,visual,2,Practice regularly
ST-124,73,26,99,50%,22,22,63,107,54%,43,50,29,122,61%,20,22,20,62,31%,34,49,38,121,61%,37,53,30,120,60%,631,53%,auditory,3,Ask questions
ST-125,81,34,115,58%,55,60,55,170,85%,29,64,58,151,76%,53,59,28,140,70%,30,77,36,143,72%,60,39,32,131,66%,850,71%,visual,1,Join study group
ST-126,64,84,148,74%,36,76,27,139,70%,59,21,23,103,52%,35,66,21,122,61%,67,33,20,120,60%,20,34,28,82,41%,714,60%,kinesthetic,5,Study more
ST-127,73,93,166,83%,36,46,44,126,63%,40,75,37,152,76%,62,26,32,120,60%,58,26,24,108,54%,37,51,23,111,56%,783,65%,kinesthetic,2,Join study group
ST-128,41,69,110,55%,39,76,54,169,85%,47,70,25,142,71%,35,68,22,125,63%,69,63,25,157,79%,30,67,24,121,61%,824,69%,kinesthetic,1,Ask questions
ST-129,84,37,121,61%,50,54,35,139,70%,55,77,77,209,105%,24,50,27,101,51%,28,33,31,92,46%,44,40,32,116,58%,778,65%,auditory,4,Join study group
ST-130,96,75,171,86%,28,59,60,147,74%,53,29,72,154,77%,64,74,30,168,84%,63,79,29,171,86%,39,56,21,116,58%,927,77%,auditory,1,Practice regularly
ST-131,84,67,151,76%,44,51,30,125,63%,57,78,35,170,85%,77,32,24,133,67%,40,51,21,112,56%,67,62,25,154,77%,845,70%,visual,3,Practice regularly
ST-132,50,56,106,53%,39,76,38,153,77%,32,27,54,113,57%,55,45,26,126,63%,33,78,37,148,74%,27,30,25,82,41%,728,61%,auditory,5,Practice regularly
ST-133,48,91,139,70%,37,25,40,102,51%,48,59,52,159,80%,54,38,29,121,61%,68,21,28,117,59%,60,74,29,163,82%,801,67%,kinesthetic,4,Practice regularly
ST-134,56,46,102,51%,24,38,78,140,70%,26,39,65,130,65%,22,28,38,88,44%,63,20,22,105,53%,25,77,29,131,66%,696,58%,kinesthetic,5,Practice regularly
ST-135,35,61,96,48%,56,54,52,162,81%,43,57,44,144,72%,79,71,39,189,95%,54,35,34,123,62%,76,44,27,147,74%,861,72%,kinesthetic,2,Study more
ST-136,23,45,68,34%,55,60,34,149,75%,32,63,60,155,78%,42,42,39,123,62%,78,35,39,152,76%,47,24,29,100,50%,747,62%,kinesthetic,4,Study more
ST-137,20,30,50,25%,20,34,78,132,66%,58,44,25,127,64%,28,29,24,81,41%,36,41,32,109,55%,66,33,20,119,60%,618,52%,kinesthetic,5,Ask questions
ST-138,51,89,140,70%,35,72,38,145,73%,34,21,75,130,65%,51,52,30,133,67%,26,33,22,81,41%,67,76,23,166,83%,795,66%,visual,4,Study more
ST-139,59,64,123,62%,41,41,55,137,69%,59,63,58,180,90%,45,67,24,136,68%,34,70,27,131,66%,43,57,34,134,67%,841,70%,kinesthetic,3,Ask questions
ST-140,25,47,72,36%,31,68,73,172,86%,35,32,38,105,53%,39,34,27,100,50%,65,73,22,160,80%,62,29,23,114,57%,723,60%,visual,2,Study more
ST-141,21,36,57,29%,41,38,67,146,73%,55,47,79,181,91%,50,54,28,132,66%,30,60,22,112,56%,43,32,31,106,53%,734,61%,visual,4,Join study group
ST-142,88,54,142,71%,45,24,78,147,74%,54,67,71,192,96%,42,43,39,124,62%,53,45,36,134,67%,41,67,30,138,69%,877,73%,visual,5,Study more
ST-143,57,77,134,67%,24,75,76,175,88%,57,74,65,196,98%,44,51,37,132,66%,24,47,36,107,54%,62,46,36,144,72%,888,74%,auditory,4,Study more
ST-144,28,96,124,62%,34,35,22,91,46%,31,72,44,147,74%,65,25,26,116,58%,61,72,31,164,82%,57,39,35,131,66%,773,64%,visual,3,Ask questions
ST-145,42,49,91,46%,54,47,43,144,72%,48,66,55,169,85%,64,61,25,150,75%,40,75,25,140,70%,20,79,21,120,60%,814,68%,visual,4,Ask questions
ST-146,74,84,158,79%,53,39,75,167,84%,51,24,72,147,74%,41,64,34,139,70%,70,21,38,129,65%,63,78,31,172,86%,912,76%,visual,3,Study more
ST-147,53,47,100,50%,28,52,24,104,52%,32,21,35,88,44%,28,59,24,111,56%,49,69,37,155,78%,22,78,26,126,63%,684,57%,auditory,4,Study more
ST-148,99,84,183,92%,21,78,51,150,75%,57,60,59,176,88%,60,58,29,147,74%,55,75,38,168,84%,47,52,37,136,68%,960,80%,visual,2,Study more
ST-149,89,73,162,81%,30,45,31,106,53%,32,73,74,179,90%,64,64,37,165,83%,75,70,27,172,86%,46,29,33,108,54%,892,74%,auditory,1,Practice regularly
ST-150,71,48,119,60%,56,20,43,119,60%,39,36,65,140,70%,47,62,34,143,72%,28,70,33,131,66%,46,40,36,122,61%,774,65%,visual,3,Practice regularly
ST-151,51,28,79,40%,49,49,54,152,76%,29,33,49,111,56%,49,21,30,100,50%,72,35,25,132,66%,55,65,20,140,70%,714,60%,auditory,4,Ask questions
ST-152,71,24,95,48%,21,32,47,100,50%,45,74,69,188,94%,47,59,27,133,67%,27,45,36,108,54%,75,55,39,169,85%,793,66%,kinesthetic,4,Join study group
ST-153,58,61,119,60%,34,54,33,121,61%,48,62,58,168,84%,54,67,33,154,77%,78,43,22,143,72%,41,45,29,115,58%,820,68%,visual,3,Study more
ST-154,46,32,78,39%,57,34,25,116,58%,57,71,34,162,81%,50,22,32,104,52%,73,24,34,131,66%,33,31,30,94,47%,685,57%,auditory,2,Practice regularly
ST-155,80,76,156,78%,56,25,74,155,78%,44,62,78,184,92%,64,39,34,137,69%,63,47,26,136,68%,64,37,38,139,70%,907,76%,kinesthetic,2,Join study group
ST-156,64,26,90,45%,25,71,53,149,75%,57,40,34,131,66%,50,29,30,109,55%,38,55,23,116,58%,47,37,35,119,60%,714,60%,visual,1,Practice regularly
ST-157,76,50,126,63%,35,55,71,161,81%,35,47,25,107,54%,25,66,29,120,60%,31,66,23,120,60%,23,21,30,74,37%,708,59%,auditory,1,Practice regularly
ST-158,55,65,120,60%,51,58,34,143,72%,21,28,37,86,43%,55,47,22,124,62%,52,41,39,132,66%,67,38,34,139,70%,744,62%,auditory,2,Study more
ST-159,53,55,108,54%,39,62,61,162,81%,24,35,36,95,48%,40,49,22,111,56%,74,63,36,173,87%,65,21,37,123,62%,772,64%,auditory,3,Study more
ST-160,26,21,47,24%,34,43,20,97,49%,24,40,62,126,63%,75,45,27,147,74%,67,66,38,171,86%,21,42,29,92,46%,680,57%,visual,4,Ask questions
ST-161,65,80,145,73%,28,34,20,82,41%,42,65,70,177,89%,21,41,34,96,48%,42,42,30,114,57%,35,31,34,100,50%,714,60%,kinesthetic,2,Ask questions
ST-162,38,40,78,39%,29,51,41,121,61%,35,76,51,162,81%,24,43,27,94,47%,37,27,29,93,47%,35,75,38,148,74%,696,58%,auditory,4,Ask questions
ST-163,93,43,136,68%,35,58,48,141,71%,22,70,62,154,77%,61,45,24,130,65%,69,72,24,165,83%,69,24,27,120,60%,846,71%,visual,4,Practice regularly
ST-164,93,59,152,76%,35,71,34,140,70%,55,61,73,189,95%,73,57,25,155,78%,75,67,38,180,90%,40,48,30,118,59%,934,78%,kinesthetic,4,Study more
ST-165,70,79,149,75%,25,73,67,165,83%,36,66,28,130,65%,60,32,20,112,56%,32,41,26,99,50%,66,59,32,157,79%,812,68%,kinesthetic,2,Ask questions
ST-166,20,33,53,27%,20,33,63,116,58%,20,48,32,100,50%,24,22,32,78,39%,76,78,27,181,91%,35,62,25,122,61%,650,54%,kinesthetic,4,Join study group
ST-167,56,42,98,49%,33,45,24,102,51%,58,61,39,158,79%,74,52,39,165,83%,31,61,30,122,61%,44,40,30,114,57%,759,63%,visual,4,Study more
ST-168,34,94,128,64%,21,63,55,139,70%,57,56,25,138,69%,30,58,20,108,54%,55,22,23,100,50%,44,43,21,108,54%,721,60%,kinesthetic,2,Study more
ST-169,99,58,157,79%,30,67,48,145,73%,49,63,66,178,89%,75,47,21,143,72%,52,49,20,121,61%,76,44,26,146,73%,890,74%,auditory,2,Ask questions
ST-170,35,57,92,46%,22,42,47,111,56%,57,73,72,202,101%,27,63,39,129,65%,29,26,27,82,41%,38,47,31,116,58%,732,61%,visual,3,Join study group
ST-171,27,48,75,38%,42,66,46,154,77%,58,59,42,159,80%,61,49,36,146,73%,33,52,31,116,58%,48,66,23,137,69%,787,66%,kinesthetic,1,Ask questions
ST-172,59,50,109,55%,20,71,44,135,68%,27,35,40,102,51%,36,41,26,103,52%,29,71,31,131,66%,29,67,22,118,59%,698,58%,kinesthetic,1,Practice regularly
ST-173,54,31,85,43%,52,73,28,153,77%,46,47,78,171,86%,46,33,33,112,56%,66,71,37,174,87%,61,39,37,137,69%,832,69%,auditory,4,Ask questions
ST-174,77,78,155,78%,42,35,48,125,63%,27,45,49,121,61%,71,72,34,177,89%,42,37,29,108,54%,62,20,28,110,55%,796,66%,visual,1,Study more
ST-175,52,75,127,64%,34,43,75,152,76%,51,50,43,144,72%,23,42,24,89,45%,28,65,21,114,57%,57,20,20,97,49%,723,60%,visual,1,Study more
ST-176,28,36,64,32%,36,52,50,138,69%,27,52,53,132,66%,32,66,26,124,62%,45,51,24,120,60%,67,21,35,123,62%,701,58%,auditory,4,Practice regularly
ST-177,58,67,125,63%,31,57,41,129,65%,23,33,72,128,64%,45,45,36,126,63%,79,54,33,166,83%,50,52,25,127,64%,801,67%,visual,4,Practice regularly
ST-178,55,20,75,38%,21,40,71,132,66%,29,43,57,129,65%,28,78,34,140,70%,62,47,22,131,66%,61,29,30,120,60%,727,61%,kinesthetic,1,Ask questions
ST-179,73,83,156,78%,29,29,70,128,64%,53,55,44,152,76%,29,21,25,75,38%,37,71,33,141,71%,61,45,24,130,65%,782,65%,visual,3,Ask questions
ST-180,23,21,44,22%,53,65,36,154,77%,46,74,46,166,83%,72,45,29,146,73%,78,67,28,173,87%,42,28,36,106,53%,789,66%,kinesthetic,4,Study more
ST-181,93,89,182,91%,23,68,33,124,62%,45,68,45,158,79%,46,28,24,98,49%,36,71,39,146,73%,50,44,23,117,59%,825,69%,visual,4,Ask questions
ST-182,52,98,150,75%,42,64,79,185,93%,33,71,33,137,69%,63,65,34,162,81%,50,65,34,149,75%,35,78,30,143,72%,926,77%,auditory,1,Join study group
ST-183,68,27,95,48%,20,67,30,117,59%,40,21,77,138,69%,47,24,35,106,53%,65,35,25,125,63%,79,75,21,175,88%,756,63%,auditory,4,Ask questions
ST-184,67,72,139,70%,54,78,52,184,92%,58,40,79,177,89%,70,20,30,120,60%,64,55,35,154,77%,77,30,35,142,71%,916,76%,auditory,3,Study more
ST-185,80,40,120,60%,54,26,53,133,67%,59,22,40,121,61%,45,79,28,152,76%,59,44,36,139,70%,34,58,31,123,62%,788,66%,visual,1,Join study group
ST-186,74,65,139,70%,50,29,79,158,79%,35,44,60,139,70%,43,72,36,151,76%,51,22,27,100,50%,49,28,23,100,50%,787,66%,visual,5,Study more
ST-187,57,66,123,62%,48,79,42,169,85%,48,42,46,136,68%,57,53,20,130,65%,53,76,28,157,79%,31,36,36,103,52%,818,68%,kinesthetic,1,Join study group
ST-188,96,63,159,80%,25,54,50,129,65%,22,28,36,86,43%,71,52,31,154,77%,37,24,28,89,45%,34,70,20,124,62%,741,62%,kinesthetic,5,Practice regularly
ST-189,22,67,89,45%,41,64,24,129,65%,48,79,50,177,89%,63,77,26,166,83%,28,77,24,129,65%,39,28,32,99,50%,789,66%,auditory,2,Study more
ST-190,20,71,91,46%,39,22,57,118,59%,58,73,45,176,88%,79,36,27,142,71%,22,26,21,69,35%,49,62,28,139,70%,735,61%,auditory,1,Ask questions
ST-191,31,85,116,58%,59,63,32,154,77%,21,30,50,101,51%,50,33,33,116,58%,33,57,31,121,61%,65,60,35,160,80%,768,64%,kinesthetic,5,Join study group
ST-192,71,56,127,64%,20,63,36,119,60%,37,63,53,153,77%,47,30,31,108,54%,70,45,22,137,69%,31,46,27,104,52%,748,62%,kinesthetic,3,Ask questions
ST-193,37,24,61,31%,23,64,75,162,81%,56,38,46,140,70%,67,25,24,116,58%,68,38,33,139,70%,66,40,24,130,65%,748,62%,kinesthetic,5,Join study group
ST-194,67,24,91,46%,26,25,63,114,57%,39,65,67,171,86%,25,67,31,123,62%,24,30,31,85,43%,47,22,20,89,45%,673,56%,kinesthetic,1,Study more
ST-195,61,88,149,75%,20,23,75,118,59%,20,50,75,145,73%,78,49,26,153,77%,31,71,31,133,67%,36,32,22,90,45%,788,66%,auditory,3,Ask questions
ST-196,62,24,86,43%,52,79,74,205,103%,32,74,54,160,80%,53,32,27,112,56%,54,54,36,144,72%,68,35,31,134,67%,841,70%,auditory,1,Ask questions
ST-197,38,93,131,66%,54,21,78,153,77%,34,30,66,130,65%,68,64,26,158,79%,37,48,37,122,61%,73,33,29,135,68%,829,69%,auditory,3,Practice regularly
ST-198,67,50,117,59%,58,41,64,163,82%,45,55,78,178,89%,32,37,35,104,52%,62,57,23,142,71%,25,47,38,110,55%,814,68%,visual,4,Ask questions
ST-199,32,31,63,32%,33,60,46,139,70%,43,48,65,156,78%,64,49,26,139,70%,70,76,25,171,86%,20,61,23,104,52%,772,64%,auditory,5,Ask questions
ST-200,96,92,188,94%,27,47,68,142,71%,58,51,72,181,91%,70,43,25,138,69%,67,46,29,142,71%,53,73,20,146,73%,937,78%,kinesthetic,1,Practice regularly
ST-201,50,84,134,67%,50,29,43,122,61%,36,58,37,131,66%,61,75,26,162,81%,71,49,34,154,77%,21,53,32,106,53%,809,67%,auditory,3,Study more
ST-202,41,20,61,31%,52,24,58,134,67%,51,35,59,145,73%,31,39,32,102,51%,44,70,33,147,74%,52,78,35,165,83%,754,63%,visual,5,Ask questions
ST-203,89,32,121,61%,52,43,40,135,68%,33,77,30,140,70%,43,72,25,140,70%,60,28,20,108,54%,40,58,21,119,60%,763,64%,visual,4,Join study group
ST-204,72,62,134,67%,29,77,36,142,71%,54,38,43,135,68%,55,41,21,117,59%,39,43,31,113,57%,23,50,31,104,52%,745,62%,kinesthetic,4,Study more
ST-205,34,92,126,63%,41,35,57,133,67%,44,45,59,148,74%,65,46,37,148,74%,26,74,30,130,65%,37,63,22,122,61%,807,67%,visual,5,Study more
ST-206,79,27,106,53%,37,28,55,120,60%,53,70,65,188,94%,35,75,34,144,72%,62,35,29,126,63%,70,77,37,184,92%,868,72%,kinesthetic,1,Join study group
ST-207,96,89,185,93%,41,29,34,104,52%,56,61,73,190,95%,56,25,31,112,56%,26,59,29,114,57%,70,76,20,166,83%,871,73%,visual,3,Ask questions
ST-208,68,94,162,81%,33,72,65,170,85%,57,50,36,143,72%,62,51,38,151,76%,23,56,22,101,51%,53,33,38,124,62%,851,71%,visual,2,Practice regularly
ST-209,75,78,153,77%,48,60,62,170,85%,26,56,26,108,54%,49,27,36,112,56%,31,49,22,102,51%,27,27,39,93,47%,738,62%,auditory,1,Practice regularly
ST-210,66,44,110,55%,27,21,62,110,55%,48,74,22,144,72%,70,28,27,125,63%,33,37,25,95,48%,70,23,21,114,57%,698,58%,kinesthetic,5,Study more
ST-211,20,23,43,22%,46,54,36,136,68%,56,78,34,168,84%,59,45,32,136,68%,42,52,37,131,66%,45,61,22,128,64%,742,62%,auditory,2,Ask questions
ST-212,80,22,102,51%,28,70,79,177,89%,38,53,64,155,78%,37,71,35,143,72%,25,74,38,137,69%,74,59,29,162,81%,876,73%,kinesthetic,4,Ask questions
ST-213,92,45,137,69%,22,46,65,133,67%,40,42,20,102,51%,41,36,33,110,55%,37,21,33,91,46%,20,23,38,81,41%,654,55%,kinesthetic,1,Practice regularly
ST-214,40,50,90,45%,33,67,53,153,77%,45,57,51,153,77%,62,45,26,133,67%,26,68,38,132,66%,40,48,31,119,60%,780,65%,auditory,5,Join study group
ST-215,82,21,103,52%,31,66,47,144,72%,34,62,79,175,88%,29,55,37,121,61%,66,20,26,112,56%,35,48,31,114,57%,769,64%,kinesthetic,3,Practice regularly
ST-216,69,20,89,45%,27,34,41,102,51%,39,37,52,128,64%,65,29,23,117,59%,51,23,36,110,55%,67,46,29,142,71%,688,57%,visual,5,Study more
ST-217,58,73,131,66%,37,47,58,142,71%,39,50,34,123,62%,76,48,38,162,81%,39,26,30,95,48%,68,57,25,150,75%,803,67%,kinesthetic,3,Ask questions
ST-218,88,42,130,65%,56,22,30,108,54%,29,61,68,158,79%,22,57,30,109,55%,64,22,27,113,57%,73,46,32,151,76%,769,64%,visual,1,Join study group
ST-219,99,70,169,85%,59,66,38,163,82%,20,42,69,131,66%,27,78,34,139,70%,76,57,39,172,86%,50,47,22,119,60%,893,74%,kinesthetic,4,Ask questions
ST-220,96,81,177,89%,38,64,69,171,86%,54,49,31,134,67%,42,27,26,95,48%,53,27,20,100,50%,31,33,39,103,52%,780,65%,visual,4,Study more
ST-221,95,56,151,76%,55,28,28,111,56%,25,59,37,121,61%,76,64,37,177,89%,21,52,37,110,55%,60,23,30,113,57%,783,65%,visual,3,Study more
ST-222,37,43,80,40%,56,78,52,186,93%,37,31,70,138,69%,42,64,30,136,68%,78,35,25,138,69%,20,65,34,119,60%,797,66%,auditory,4,Practice regularly
ST-223,62,46,108,54%,32,32,60,124,62%,20,50,23,93,47%,47,38,36,121,61%,70,70,28,168,84%,55,23,35,113,57%,727,61%,auditory,1,Study more
ST-224,86,42,128,64%,43,37,22,102,51%,56,62,57,175,88%,78,47,30,155,78%,72,45,38,155,78%,49,58,20,127,64%,842,70%,kinesthetic,4,Study more
ST-225,95,34,129,65%,55,52,22,129,65%,58,23,67,148,74%,29,78,21,128,64%,71,52,26,149,75%,76,36,23,135,68%,818,68%,kinesthetic,4,Join study group
ST-226,44,77,121,61%,32,63,79,174,87%,30,76,56,162,81%,41,25,28,94,47%,22,43,34,99,50%,77,73,37,187,94%,837,70%,kinesthetic,2,Study more
ST-227,60,94,154,77%,41,32,77,150,75%,46,45,24,115,58%,55,20,31,106,53%,51,48,28,127,64%,45,49,35,129,65%,781,65%,kinesthetic,1,Practice regularly
ST-228,64,86,150,75%,45,49,74,168,84%,48,28,24,100,50%,76,73,33,182,91%,66,46,22,134,67%,29,32,38,99,50%,833,69%,auditory,4,Practice regularly
ST-229,79,20,99,50%,40,63,22,125,63%,31,78,33,142,71%,60,24,37,121,61%,27,77,38,142,71%,25,58,38,121,61%,750,63%,kinesthetic,1,Ask questions
ST-230,57,73,130,65%,51,48,72,171,86%,37,33,55,125,63%,35,78,20,133,67%,61,40,28,129,65%,48,66,37,151,76%,839,70%,kinesthetic,1,Join study group
ST-231,54,66,120,60%,41,69,42,152,76%,25,30,50,105,53%,49,73,37,159,80%,46,55,30,131,66%,28,33,34,95,48%,762,64%,visual,4,Study more
ST-232,33,44,77,39%,39,36,40,115,58%,28,58,48,134,67%,49,38,27,114,57%,30,47,24,101,51%,32,54,33,119,60%,660,55%,auditory,5,Join study group
ST-233,71,59,130,65%,51,43,47,141,71%,30,33,29,92,46%,65,53,26,144,72%,62,55,35,152,76%,60,41,23,124,62%,783,65%,auditory,3,Ask questions
ST-234,35,93,128,64%,43,59,51,153,77%,52,78,51,181,91%,63,38,30,131,66%,23,74,36,133,67%,39,70,38,147,74%,873,73%,visual,2,Ask questions
ST-235,24,52,76,38%,26,74,59,159,80%,28,62,26,116,58%,23,58,22,103,52%,45,27,33,105,53%,65,22,35,122,61%,681,57%,auditory,2,Practice regularly
ST-236,66,68,134,67%,57,26,70,153,77%,20,76,28,124,62%,56,70,28,154,77%,78,48,21,147,74%,66,20,22,108,54%,820,68%,auditory,2,Practice regularly
ST-237,46,79,125,63%,37,65,60,162,81%,56,29,39,124,62%,30,48,33,111,56%,42,79,30,151,76%,28,30,32,90,45%,763,64%,visual,1,Join study group
ST-238,93,52,145,73%,33,54,56,143,72%,29,24,70,123,62%,63,72,23,158,79%,73,22,22,117,59%,58,77,37,172,86%,858,72%,kinesthetic,2,Ask questions
ST-239,51,35,86,43%,56,21,27,104,52%,40,34,51,125,63%,79,54,21,154,77%,38,49,28,115,58%,35,50,31,116,58%,700,58%,auditory,5,Study more
ST-240,88,46,134,67%,40,23,59,122,61%,30,70,24,124,62%,26,38,34,98,49%,33,31,27,91,46%,65,34,33,132,66%,701,58%,kinesthetic,3,Study more
ST-241,56,23,79,40%,26,52,70,148,74%,36,70,29,135,68%,43,36,31,110,55%,34,50,29,113,57%,53,24,32,109,55%,694,58%,auditory,2,Study more
ST-242,86,46,132,66%,29,35,26,90,45%,35,26,27,88,44%,31,56,36,123,62%,31,39,31,101,51%,46,27,36,109,55%,643,54%,auditory,3,Join study group
ST-243,74,65,139,70%,49,64,35,148,74%,47,27,58,132,66%,20,71,32,123,62%,69,25,39,133,67%,67,72,34,173,87%,848,71%,auditory,2,Join study group
ST-244,88,68,156,78%,21,67,23,111,56%,26,31,78,135,68%,39,48,35,122,61%,57,40,23,120,60%,23,54,31,108,54%,752,63%,visual,2,Join study group
ST-245,40,75,115,58%,24,55,44,123,62%,57,40,69,166,83%,27,78,28,133,67%,27,24,39,90,45%,58,55,21,134,67%,761,63%,visual,5,Join study group
ST-246,64,67,131,66%,59,46,72,177,89%,21,46,65,132,66%,67,20,24,111,56%,56,60,27,143,72%,33,46,21,100,50%,794,66%,visual,2,Join study group
ST-247,72,86,158,79%,38,52,75,165,83%,56,60,49,165,83%,51,63,32,146,73%,28,35,37,100,50%,41,23,22,86,43%,820,68%,auditory,4,Ask questions
ST-248,91,46,137,69%,35,31,26,92,46%,49,71,71,191,96%,23,78,25,126,63%,36,71,38,145,73%,79,28,33,140,70%,831,69%,auditory,1,Practice regularly
ST-249,49,39,88,44%,48,63,58,169,85%,35,46,45,126,63%,50,36,29,115,58%,47,45,26,118,59%,28,66,32,126,63%,742,62%,auditory,1,Join study group
ST-250,82,55,137,69%,50,57,51,158,79%,53,22,47,122,61%,22,29,28,79,40%,71,59,21,151,76%,50,57,24,131,66%,778,65%,auditory,3,Join study group
ST-251,69,56,125,63%,53,36,61,150,75%,50,38,71,159,80%,65,51,36,152,76%,49,20,33,102,51%,32,60,28,120,60%,808,67%,kinesthetic,5,Join study group
ST-252,28,34,62,31%,46,26,24,96,48%,58,37,63,158,79%,50,59,39,148,74%,42,74,29,145,73%,50,73,30,153,77%,762,64%,kinesthetic,3,Join study group
ST-253,39,59,98,49%,35,49,32,116,58%,39,34,72,145,73%,64,28,39,131,66%,25,24,36,85,43%,51,74,25,150,75%,725,60%,auditory,5,Practice regularly
ST-254,66,91,157,79%,47,22,75,144,72%,28,55,77,160,80%,78,63,29,170,85%,29,37,20,86,43%,32,51,27,110,55%,827,69%,visual,1,Ask questions
ST-255,48,57,105,53%,47,69,21,137,69%,41,64,72,177,89%,43,55,26,124,62%,58,32,22,112,56%,53,49,37,139,70%,794,66%,visual,1,Join study group
ST-256,77,94,171,86%,27,38,28,93,47%,48,69,40,157,79%,39,54,26,119,60%,52,44,35,131,66%,77,51,24,152,76%,823,69%,visual,3,Ask questions
ST-257,35,47,82,41%,37,66,63,166,83%,40,20,50,110,55%,47,72,38,157,79%,30,51,37,118,59%,44,74,20,138,69%,771,64%,kinesthetic,2,Study more
ST-258,85,50,135,68%,33,51,25,109,55%,24,61,43,128,64%,58,74,33,165,83%,61,63,24,148,74%,74,54,33,161,81%,846,71%,auditory,5,Practice regularly
ST-259,52,61,113,57%,36,58,59,153,77%,21,67,48,136,68%,65,59,33,157,79%,24,41,35,100,50%,70,56,20,146,73%,805,67%,kinesthetic,2,Ask questions
ST-260,35,55,90,45%,21,77,70,168,84%,49,53,54,156,78%,45,52,39,136,68%,24,69,24,117,59%,67,62,23,152,76%,819,68%,visual,4,Study more
ST-261,74,98,172,86%,26,47,41,114,57%,24,36,71,131,66%,76,60,23,159,80%,28,69,38,135,68%,26,29,33,88,44%,799,67%,auditory,5,Join study group
ST-262,91,96,187,94%,21,64,46,131,66%,29,68,67,164,82%,57,62,24,143,72%,26,67,23,116,58%,22,75,25,122,61%,863,72%,kinesthetic,1,Study more
ST-263,56,58,114,57%,32,75,25,132,66%,39,22,22,83,42%,40,64,33,137,69%,75,56,27,158,79%,71,40,32,143,72%,767,64%,kinesthetic,1,Practice regularly
ST-264,30,20,50,25%,55,71,75,201,101%,26,78,74,178,89%,29,35,34,98,49%,37,45,31,113,57%,51,24,29,104,52%,744,62%,visual,5,Study more
ST-265,29,82,111,56%,45,75,54,174,87%,49,79,22,150,75%,39,28,38,105,53%,21,61,32,114,57%,68,20,22,110,55%,764,64%,visual,4,Ask questions
ST-266,26,67,93,47%,32,27,35,94,47%,32,43,24,99,50%,74,21,26,121,61%,29,31,38,98,49%,23,37,33,93,47%,598,50%,auditory,3,Study more
ST-267,80,21,101,51%,31,52,79,162,81%,20,74,48,142,71%,40,58,33,131,66%,50,62,22,134,67%,66,40,27,133,67%,803,67%,kinesthetic,4,Practice regularly
ST-268,54,53,107,54%,25,23,63,111,56%,43,57,44,144,72%,27,61,30,118,59%,51,32,24,107,54%,75,31,39,145,73%,732,61%,kinesthetic,2,Ask questions
ST-269,94,44,138,69%,54,31,47,132,66%,32,44,36,112,56%,42,69,30,141,71%,61,58,20,139,70%,22,77,39,138,69%,800,67%,kinesthetic,2,Practice regularly
ST-270,87,94,181,91%,22,23,72,117,59%,54,55,42,151,76%,44,20,32,96,48%,24,39,33,96,48%,63,28,23,114,57%,755,63%,visual,1,Join study group
ST-271,33,23,56,28%,27,30,57,114,57%,47,63,75,185,93%,29,67,29,125,63%,57,66,39,162,81%,65,72,27,164,82%,806,67%,visual,1,Study more
ST-272,40,47,87,44%,45,26,78,149,75%,36,53,59,148,74%,33,73,20,126,63%,27,49,36,112,56%,23,79,36,138,69%,760,63%,auditory,1,Practice regularly
ST-273,77,85,162,81%,41,21,46,108,54%,49,62,52,163,82%,66,55,29,150,75%,35,37,35,107,54%,31,66,35,132,66%,822,69%,visual,2,Practice regularly
ST-274,45,88,133,67%,40,72,46,158,79%,55,23,60,138,69%,54,57,27,138,69%,53,44,36,133,67%,58,61,34,153,77%,853,71%,visual,3,Study more
ST-275,61,67,128,64%,25,23,56,104,52%,56,76,73,205,103%,70,30,36,136,68%,51,57,31,139,70%,73,25,34,132,66%,844,70%,kinesthetic,2,Study more
ST-276,85,51,136,68%,29,20,68,117,59%,50,53,66,169,85%,49,45,31,125,63%,56,38,21,115,58%,72,78,38,188,94%,850,71%,auditory,3,Study more
ST-277,32,81,113,57%,46,28,73,147,74%,44,73,78,195,98%,52,45,23,120,60%,23,62,27,112,56%,73,20,30,123,62%,810,68%,kinesthetic,4,Practice regularly
ST-278,37,33,70,35%,29,31,78,138,69%,41,53,40,134,67%,28,40,38,106,53%,63,43,31,137,69%,29,58,36,123,62%,708,59%,visual,3,Ask questions
ST-279,66,95,161,81%,40,78,36,154,77%,30,34,26,90,45%,25,22,26,73,37%,25,20,25,70,35%,45,44,36,125,63%,673,56%,visual,1,Study more
ST-280,66,40,106,53%,42,47,37,126,63%,59,67,69,195,98%,39,53,29,121,61%,58,51,39,148,74%,57,63,38,158,79%,854,71%,kinesthetic,4,Practice regularly
ST-281,55,46,101,51%,42,68,57,167,84%,56,53,39,148,74%,31,21,31,83,42%,62,75,36,173,87%,76,65,30,171,86%,843,70%,kinesthetic,1,Study more
ST-282,38,76,114,57%,52,62,30,144,72%,56,47,61,164,82%,57,29,27,113,57%,22,79,32,133,67%,54,38,39,131,66%,799,67%,kinesthetic,3,Ask questions
ST-283,56,95,151,76%,51,67,75,193,97%,53,22,60,135,68%,79,64,25,168,84%,34,34,27,95,48%,43,40,22,105,53%,847,71%,visual,2,Ask questions
ST-284,94,61,155,78%,47,29,69,145,73%,38,73,20,131,66%,47,23,22,92,46%,53,41,20,114,57%,61,26,23,110,55%,747,62%,visual,2,Ask questions
ST-285,30,83,113,57%,25,75,50,150,75%,59,75,76,210,105%,28,32,26,86,43%,38,66,33,137,69%,33,39,27,99,50%,795,66%,auditory,4,Ask questions
ST-286,82,63,145,73%,39,79,66,184,92%,47,34,34,115,58%,62,61,23,146,73%,22,37,21,80,40%,20,60,27,107,54%,777,65%,kinesthetic,2,Ask questions
ST-287,96,56,152,76%,40,78,75,193,97%,37,76,59,172,86%,42,35,24,101,51%,21,37,39,97,49%,48,33,36,117,59%,832,69%,visual,3,Ask questions
ST-288,76,28,104,52%,50,48,64,162,81%,33,36,78,147,74%,68,70,31,169,85%,25,54,38,117,59%,45,28,38,111,56%,810,68%,visual,2,Study more
ST-289,52,96,148,74%,26,73,61,160,80%,39,78,46,163,82%,46,74,29,149,75%,69,51,31,151,76%,23,30,25,78,39%,849,71%,auditory,3,Practice regularly
ST-290,85,75,160,80%,47,53,63,163,82%,59,79,25,163,82%,36,65,28,129,65%,23,60,34,117,59%,58,56,39,153,77%,885,74%,kinesthetic,4,Study more
ST-291,87,23,110,55%,49,60,52,161,81%,25,71,46,142,71%,50,41,35,126,63%,26,77,21,124,62%,57,47,29,133,67%,796,66%,kinesthetic,1,Ask questions
ST-292,70,30,100,50%,54,40,41,135,68%,44,70,78,192,96%,67,55,28,150,75%,59,35,33,127,64%,56,74,30,160,80%,864,72%,visual,5,Study more
ST-293,71,38,109,55%,51,56,20,127,64%,21,53,23,97,49%,59,36,30,125,63%,42,30,24,96,48%,53,27,35,115,58%,669,56%,auditory,3,Practice regularly
ST-294,82,32,114,57%,32,40,24,96,48%,50,60,43,153,77%,68,37,24,129,65%,49,24,38,111,56%,30,23,27,80,40%,683,57%,kinesthetic,5,Practice regularly
ST-295,22,65,87,44%,59,69,58,186,93%,23,72,63,158,79%,57,29,20,106,53%,62,55,26,143,72%,42,34,21,97,49%,777,65%,kinesthetic,3,Practice regularly
ST-296,93,39,132,66%,54,74,43,171,86%,31,20,65,116,58%,54,71,37,162,81%,23,32,34,89,45%,65,56,27,148,74%,818,68%,kinesthetic,4,Practice regularly
ST-297,34,41,75,38%,45,26,46,117,59%,33,41,61,135,68%,38,74,21,133,67%,68,59,23,150,75%,30,23,30,83,42%,693,58%,kinesthetic,5,Practice regularly
ST-298,63,82,145,73%,20,54,30,104,52%,35,65,22,122,61%,67,57,26,150,75%,46,44,20,110,55%,51,43,31,125,63%,756,63%,auditory,4,Join study group
ST-299,66,25,91,46%,23,49,21,93,47%,33,30,46,109,55%,40,24,39,103,52%,24,45,23,92,46%,79,66,28,173,87%,661,55%,auditory,1,Join study group
ST-300,34,83,117,59%,27,47,41,115,58%,38,55,35,128,64%,36,30,20,86,43%,56,28,28,112,56%,26,20,22,68,34%,626,52%,auditory,2,Practice regularly
ST-301,78,70,148,74%,26,56,33,115,58%,28,23,26,77,39%,37,78,38,153,77%,38,33,39,110,55%,30,70,29,129,65%,732,61%,auditory,2,Ask questions
ST-302,49,94,143,72%,47,26,58,131,66%,43,71,52,166,83%,50,68,25,143,72%,50,47,26,123,62%,31,53,36,120,60%,826,69%,auditory,4,Study more
ST-303,38,72,110,55%,44,35,43,122,61%,33,79,24,136,68%,36,34,39,109,55%,50,76,31,157,79%,35,25,26,86,43%,720,60%,auditory,4,Ask questions
ST-304,94,92,186,93%,51,56,73,180,90%,49,57,75,181,91%,41,50,34,125,63%,74,47,30,151,76%,48,45,34,127,64%,950,79%,kinesthetic,4,Practice regularly
ST-305,85,66,151,76%,40,21,20,81,41%,40,30,74,144,72%,66,26,29,121,61%,23,66,29,118,59%,35,64,39,138,69%,753,63%,auditory,4,Ask questions
ST-306,57,87,144,72%,47,60,61,168,84%,35,46,67,148,74%,48,67,27,142,71%,21,65,24,110,55%,70,63,39,172,86%,884,74%,kinesthetic,1,Join study group
ST-307,33,92,125,63%,36,23,31,90,45%,45,60,60,165,83%,77,22,23,122,61%,62,58,27,147,74%,54,64,33,151,76%,800,67%,kinesthetic,2,Study more
ST-308,41,88,129,65%,43,53,28,124,62%,33,42,38,113,57%,56,55,33,144,72%,28,54,20,102,51%,70,25,23,118,59%,730,61%,auditory,3,Ask questions
ST-309,78,43,121,61%,37,79,32,148,74%,37,36,23,96,48%,20,70,29,119,60%,76,27,26,129,65%,43,43,25,111,56%,724,60%,visual,5,Ask questions
ST-310,57,54,111,56%,35,68,26,129,65%,57,31,26,114,57%,30,20,28,78,39%,49,41,22,112,56%,22,35,39,96,48%,640,53%,kinesthetic,3,Study more
ST-311,35,20,55,28%,53,40,51,144,72%,27,70,46,143,72%,60,77,30,167,84%,23,49,33,105,53%,42,49,23,114,57%,728,61%,kinesthetic,5,Practice regularly
ST-312,73,55,128,64%,59,55,66,180,90%,48,79,24,151,76%,20,46,22,88,44%,69,24,21,114,57%,47,52,32,131,66%,792,66%,kinesthetic,2,Join study group
ST-313,44,65,109,55%,36,36,45,117,59%,52,48,56,156,78%,55,72,24,151,76%,61,35,36,132,66%,33,77,37,147,74%,812,68%,auditory,4,Ask questions
ST-314,93,33,126,63%,51,77,73,201,101%,22,62,55,139,70%,56,41,20,117,59%,55,74,30,159,80%,55,60,34,149,75%,891,74%,kinesthetic,4,Join study group
ST-315,99,97,196,98%,38,32,28,98,49%,22,62,79,163,82%,22,42,20,84,42%,32,79,32,143,72%,38,25,30,93,47%,777,65%,kinesthetic,4,Join study group
ST-316,55,96,151,76%,24,62,33,119,60%,59,47,32,138,69%,69,78,30,177,89%,34,36,36,106,53%,21,37,22,80,40%,771,64%,auditory,1,Practice regularly
ST-317,67,55,122,61%,28,21,72,121,61%,49,76,66,191,96%,71,51,36,158,79%,32,46,33,111,56%,40,78,31,149,75%,852,71%,kinesthetic,5,Study more
ST-318,87,24,111,56%,55,61,72,188,94%,56,79,31,166,83%,72,29,29,130,65%,28,60,29,117,59%,61,63,22,146,73%,858,72%,visual,3,Practice regularly
ST-319,75,82,157,79%,41,25,25,91,46%,29,41,78,148,74%,76,56,24,156,78%,45,48,32,125,63%,38,25,28,91,46%,768,64%,auditory,3,Study more
ST-320,36,65,101,51%,20,23,25,68,34%,33,34,23,90,45%,78,24,28,130,65%,78,64,22,164,82%,37,54,30,121,61%,674,56%,visual,2,Study more
ST-321,58,97,155,78%,52,58,44,154,77%,41,57,63,161,81%,47,69,36,152,76%,46,56,38,140,70%,65,60,24,149,75%,911,76%,kinesthetic,1,Ask questions
ST-322,73,50,123,62%,27,66,63,156,78%,45,46,69,160,80%,25,44,24,93,47%,28,63,28,119,60%,68,54,33,155,78%,806,67%,auditory,4,Join study group
ST-323,91,22,113,57%,45,36,61,142,71%,21,44,31,96,48%,20,63,29,112,56%,26,36,30,92,46%,78,47,26,151,76%,706,59%,visual,1,Study more
ST-324,39,99,138,69%,33,55,70,158,79%,28,58,66,152,76%,50,78,25,153,77%,55,35,35,125,63%,25,29,27,81,41%,807,67%,auditory,2,Study more
ST-325,51,95,146,73%,47,28,75,150,75%,28,70,54,152,76%,29,78,20,127,64%,58,58,26,142,71%,64,60,38,162,81%,879,73%,kinesthetic,5,Ask questions
ST-326,71,49,120,60%,51,21,78,150,75%,44,69,54,167,84%,66,66,30,162,81%,61,79,30,170,85%,76,31,37,144,72%,913,76%,auditory,2,Practice regularly
ST-327,64,96,160,80%,22,42,47,111,56%,44,38,50,132,66%,27,65,32,124,62%,27,69,39,135,68%,53,22,37,112,56%,774,65%,auditory,2,Join study group
ST-328,92,43,135,68%,46,68,58,172,86%,20,38,54,112,56%,58,77,28,163,82%,64,33,39,136,68%,73,50,21,144,72%,862,72%,visual,3,Practice regularly
ST-329,96,87,183,92%,58,38,69,165,83%,47,60,27,134,67%,37,60,25,122,61%,78,57,33,168,84%,32,33,34,99,50%,871,73%,visual,1,Practice regularly
ST-330,60,65,125,63%,32,52,41,125,63%,59,76,33,168,84%,36,54,31,121,61%,39,61,32,132,66%,58,45,39,142,71%,813,68%,kinesthetic,2,Practice regularly
ST-331,35,90,125,63%,57,39,37,133,67%,54,47,22,123,62%,35,65,25,125,63%,42,67,36,145,73%,32,48,31,111,56%,762,64%,visual,4,Join study group
ST-332,60,59,119,60%,42,28,78,148,74%,55,71,62,188,94%,26,75,20,121,61%,56,35,24,115,58%,34,30,26,90,45%,781,65%,kinesthetic,1,Ask questions
ST-333,44,69,113,57%,44,37,58,139,70%,49,47,45,141,71%,37,49,30,116,58%,71,53,27,151,76%,39,49,33,121,61%,781,65%,auditory,4,Practice regularly
ST-334,86,65,151,76%,21,78,34,133,67%,29,31,28,88,44%,76,67,38,181,91%,70,26,26,122,61%,34,21,21,76,38%,751,63%,auditory,1,Ask questions
ST-335,40,56,96,48%,58,50,58,166,83%,46,61,75,182,91%,58,29,37,124,62%,66,75,24,165,83%,39,75,32,146,73%,879,73%,kinesthetic,2,Ask questions
ST-336,22,24,46,23%,22,73,40,135,68%,48,78,34,160,80%,57,48,31,136,68%,53,78,22,153,77%,54,32,32,118,59%,748,62%,visual,2,Study more
ST-337,36,24,60,30%,41,24,21,86,43%,50,75,70,195,98%,28,79,23,130,65%,48,55,28,131,66%,74,49,28,151,76%,753,63%,auditory,5,Join study group
ST-338,23,76,99,50%,25,46,76,147,74%,47,64,65,176,88%,21,45,25,91,46%,32,44,28,104,52%,62,60,39,161,81%,778,65%,auditory,5,Practice regularly
ST-339,74,86,160,80%,33,21,39,93,47%,24,51,23,98,49%,68,34,20,122,61%,70,73,23,166,83%,57,62,31,150,75%,789,66%,kinesthetic,2,Join study group
ST-340,74,96,170,85%,43,28,40,111,56%,26,76,25,127,64%,66,54,29,149,75%,51,59,21,131,66%,34,20,21,75,38%,763,64%,auditory,1,Study more
ST-341,41,68,109,55%,45,34,59,138,69%,41,27,43,111,56%,50,40,21,111,56%,77,66,37,180,90%,76,44,31,151,76%,800,67%,auditory,5,Join study group
ST-342,75,22,97,49%,25,66,38,129,65%,20,70,69,159,80%,66,65,24,155,78%,70,65,28,163,82%,55,55,23,133,67%,836,70%,kinesthetic,5,Join study group
ST-343,90,59,149,75%,39,65,49,153,77%,59,27,24,110,55%,74,56,33,163,82%,56,66,37,159,80%,77,73,23,173,87%,907,76%,visual,3,Practice regularly
ST-344,51,98,149,75%,50,46,34,130,65%,46,42,59,147,74%,24,26,29,79,40%,47,71,29,147,74%,29,36,37,102,51%,754,63%,auditory,4,Ask questions
ST-345,61,59,120,60%,34,78,74,186,93%,21,54,52,127,64%,32,67,33,132,66%,40,20,29,89,45%,42,40,24,106,53%,760,63%,auditory,2,Study more
ST-346,29,76,105,53%,39,57,29,125,63%,32,74,63,169,85%,48,35,39,122,61%,46,40,21,107,54%,73,22,30,125,63%,753,63%,kinesthetic,5,Join study group
ST-347,62,49,111,56%,43,34,28,105,53%,32,61,31,124,62%,41,61,31,133,67%,79,52,29,160,80%,28,78,36,142,71%,775,65%,visual,4,Ask questions
ST-348,23,54,77,39%,51,32,30,113,57%,50,46,26,122,61%,69,71,32,172,86%,77,78,20,175,88%,51,79,35,165,83%,824,69%,auditory,3,Join study group
ST-349,77,21,98,49%,22,46,65,133,67%,53,31,52,136,68%,40,41,27,108,54%,53,40,27,120,60%,52,49,37,138,69%,733,61%,auditory,5,Study more
ST-350,72,47,119,60%,53,32,68,153,77%,55,35,28,118,59%,38,76,20,134,67%,25,31,34,90,45%,57,36,24,117,59%,731,61%,kinesthetic,4,Join study group
ST-351,79,83,162,81%,22,42,66,130,65%,40,26,68,134,67%,27,24,27,78,39%,72,59,28,159,80%,68,62,35,165,83%,828,69%,kinesthetic,2,Practice regularly
ST-352,41,40,81,41%,55,60,45,160,80%,37,39,70,146,73%,79,40,29,148,74%,69,61,21,151,76%,70,43,28,141,71%,827,69%,auditory,1,Practice regularly
ST-353,66,37,103,52%,56,72,43,171,86%,59,74,29,162,81%,51,55,34,140,70%,76,73,27,176,88%,47,70,31,148,74%,900,75%,visual,4,Ask questions
ST-354,39,29,68,34%,45,36,33,114,57%,53,72,68,193,97%,30,75,23,128,64%,75,30,37,142,71%,60,27,35,122,61%,767,64%,auditory,4,Join study group
ST-355,34,36,70,35%,36,43,23,102,51%,23,34,55,112,56%,42,78,33,153,77%,74,35,21,130,65%,45,76,29,150,75%,717,60%,visual,5,Join study group
ST-356,49,93,142,71%,55,55,20,130,65%,37,49,47,133,67%,22,25,22,69,35%,43,76,30,149,75%,72,63,32,167,84%,790,66%,visual,4,Ask questions
ST-357,53,78,131,66%,58,76,65,199,100%,41,71,32,144,72%,22,55,20,97,49%,68,35,32,135,68%,79,56,31,166,83%,872,73%,kinesthetic,5,Study more
ST-358,76,69,145,73%,46,65,49,160,80%,41,55,23,119,60%,25,48,22,95,48%,60,55,39,154,77%,37,41,26,104,52%,777,65%,kinesthetic,5,Join study group
ST-359,39,67,106,53%,36,47,46,129,65%,27,23,62,112,56%,44,44,24,112,56%,30,20,21,71,36%,52,51,33,136,68%,666,56%,auditory,4,Study more
ST-360,86,72,158,79%,25,37,78,140,70%,39,33,42,114,57%,24,58,24,106,53%,22,67,29,118,59%,28,26,29,83,42%,719,60%,auditory,3,Study more
ST-361,75,41,116,58%,58,61,31,150,75%,20,20,32,72,36%,21,30,25,76,38%,56,55,34,145,73%,71,36,26,133,67%,692,58%,visual,4,Study more
ST-362,61,44,105,53%,55,50,20,125,63%,59,41,25,125,63%,26,34,29,89,45%,33,28,36,97,49%,52,59,28,139,70%,680,57%,visual,3,Practice regularly
ST-363,66,38,104,52%,58,64,65,187,94%,20,39,36,95,48%,33,25,30,88,44%,43,43,21,107,54%,56,52,23,131,66%,712,59%,auditory,4,Ask questions
ST-364,49,66,115,58%,31,38,53,122,61%,20,44,74,138,69%,55,29,24,108,54%,75,42,35,152,76%,66,29,26,121,61%,756,63%,visual,1,Practice regularly
ST-365,51,25,76,38%,25,78,20,123,62%,22,69,61,152,76%,32,28,25,85,43%,45,45,39,129,65%,20,57,29,106,53%,671,56%,kinesthetic,4,Practice regularly
ST-366,83,38,121,61%,46,44,44,134,67%,47,44,72,163,82%,36,72,33,141,71%,54,47,20,121,61%,52,39,38,129,65%,809,67%,visual,5,Join study group
ST-367,79,77,156,78%,48,34,47,129,65%,29,52,21,102,51%,64,41,23,128,64%,51,49,28,128,64%,68,67,37,172,86%,815,68%,kinesthetic,4,Ask questions
ST-368,88,53,141,71%,27,44,33,104,52%,49,56,70,175,88%,60,51,33,144,72%,46,43,39,128,64%,75,50,32,157,79%,849,71%,visual,3,Join study group
ST-369,99,36,135,68%,32,76,24,132,66%,37,70,29,136,68%,36,68,33,137,69%,77,53,20,150,75%,46,24,28,98,49%,788,66%,visual,2,Join study group
ST-370,88,23,111,56%,49,67,68,184,92%,50,50,78,178,89%,66,26,25,117,59%,35,22,28,85,43%,68,72,27,167,84%,842,70%,kinesthetic,5,Study more
ST-371,48,95,143,72%,55,22,70,147,74%,58,31,20,109,55%,27,65,29,121,61%,66,44,30,140,70%,66,60,23,149,75%,809,67%,visual,5,Practice regularly
ST-372,89,25,114,57%,52,68,32,152,76%,27,78,56,161,81%,70,61,38,169,85%,36,48,26,110,55%,43,70,35,148,74%,854,71%,kinesthetic,1,Practice regularly
ST-373,35,80,115,58%,56,36,33,125,63%,32,25,42,99,50%,30,78,38,146,73%,34,75,37,146,73%,42,30,22,94,47%,725,60%,kinesthetic,5,Practice regularly
ST-374,90,20,110,55%,46,78,50,174,87%,35,45,48,128,64%,54,69,39,162,81%,54,52,23,129,65%,56,72,37,165,83%,868,72%,auditory,4,Practice regularly
ST-375,91,25,116,58%,39,79,29,147,74%,56,31,42,129,65%,20,66,21,107,54%,26,61,25,112,56%,47,50,33,130,65%,741,62%,auditory,4,Study more
ST-376,32,60,92,46%,49,35,59,143,72%,30,41,63,134,67%,37,61,29,127,64%,72,46,39,157,79%,74,79,35,188,94%,841,70%,visual,5,Study more
ST-377,39,49,88,44%,50,24,31,105,53%,39,47,23,109,55%,24,37,26,87,44%,46,45,26,117,59%,71,53,34,158,79%,664,55%,visual,1,Practice regularly
ST-378,57,95,152,76%,24,27,42,93,47%,41,72,33,146,73%,75,55,20,150,75%,56,55,30,141,71%,34,59,21,114,57%,796,66%,kinesthetic,5,Practice regularly
ST-379,28,84,112,56%,45,28,38,111,56%,30,24,66,120,60%,49,20,34,103,52%,39,23,22,84,42%,79,67,38,184,92%,714,60%,kinesthetic,1,Study more
ST-380,28,79,107,54%,59,33,74,166,83%,24,78,72,174,87%,59,33,34,126,63%,37,78,32,147,74%,32,23,35,90,45%,810,68%,visual,1,Practice regularly
ST-381,35,88,123,62%,36,44,31,111,56%,39,73,65,177,89%,43,38,36,117,59%,46,73,25,144,72%,36,52,28,116,58%,788,66%,kinesthetic,3,Join study group
ST-382,37,20,57,29%,59,79,40,178,89%,26,67,64,157,79%,74,39,20,133,67%,24,70,35,129,65%,48,29,39,116,58%,770,64%,visual,2,Study more
ST-383,82,82,164,82%,27,30,54,111,56%,51,46,29,126,63%,44,50,37,131,66%,69,64,35,168,84%,40,74,33,147,74%,847,71%,visual,4,Study more
ST-384,94,95,189,95%,44,49,22,115,58%,54,29,60,143,72%,73,66,30,169,85%,41,66,35,142,71%,25,24,37,86,43%,844,70%,visual,1,Join study group
ST-385,84,59,143,72%,39,24,72,135,68%,51,44,33,128,64%,67,52,22,141,71%,40,47,33,120,60%,42,38,23,103,52%,770,64%,auditory,3,Study more
ST-386,89,30,119,60%,50,24,41,115,58%,47,49,47,143,72%,70,49,24,143,72%,74,52,30,156,78%,71,23,38,132,66%,808,67%,auditory,3,Study more
ST-387,49,88,137,69%,23,76,67,166,83%,21,43,74,138,69%,29,54,24,107,54%,52,63,35,150,75%,60,76,30,166,83%,864,72%,kinesthetic,2,Study more
ST-388,59,69,128,64%,24,37,74,135,68%,47,77,22,146,73%,35,31,22,88,44%,28,20,39,87,44%,21,30,21,72,36%,656,55%,visual,3,Study more
ST-389,95,59,154,77%,32,41,76,149,75%,39,42,67,148,74%,52,58,38,148,74%,70,63,28,161,81%,33,21,24,78,39%,838,70%,kinesthetic,3,Join study group
ST-390,48,85,133,67%,51,57,64,172,86%,46,37,42,125,63%,58,50,32,140,70%,62,73,35,170,85%,24,64,29,117,59%,857,71%,visual,3,Study more
ST-391,29,22,51,26%,59,30,41,130,65%,43,40,33,116,58%,51,20,23,94,47%,63,68,32,163,82%,53,53,35,141,71%,695,58%,visual,2,Ask questions
ST-392,37,61,98,49%,29,26,70,125,63%,39,24,63,126,63%,42,65,28,135,68%,60,78,20,158,79%,36,79,23,138,69%,780,65%,visual,3,Join study group
ST-393,66,33,99,50%,36,34,53,123,62%,33,21,35,89,45%,55,71,31,157,79%,31,26,36,93,47%,67,75,29,171,86%,732,61%,kinesthetic,2,Study more
ST-394,87,29,116,58%,33,56,44,133,67%,48,56,27,131,66%,42,35,28,105,53%,78,28,38,144,72%,58,78,33,169,85%,798,67%,visual,1,Practice regularly
ST-395,53,43,96,48%,24,59,73,156,78%,31,31,76,138,69%,36,65,20,121,61%,79,47,22,148,74%,40,68,34,142,71%,801,67%,kinesthetic,5,Practice regularly
ST-396,28,44,72,36%,42,74,74,190,95%,42,48,31,121,61%,75,67,23,165,83%,40,62,32,134,67%,43,63,28,134,67%,816,68%,kinesthetic,1,Practice regularly
ST-397,49,22,71,36%,23,43,60,126,63%,53,20,39,112,56%,63,70,39,172,86%,45,56,38,139,70%,43,73,33,149,75%,769,64%,auditory,5,Join study group
ST-398,84,35,119,60%,30,28,55,113,57%,31,43,56,130,65%,21,68,24,113,57%,33,77,22,132,66%,58,35,32,125,63%,732,61%,kinesthetic,2,Study more
ST-399,85,59,144,72%,37,76,70,183,92%,25,37,75,137,69%,65,50,20,135,68%,54,52,30,136,68%,74,61,33,168,84%,903,75%,auditory,4,Practice regularly
ST-400,82,42,124,62%,27,67,20,114,57%,37,33,61,131,66%,35,41,39,115,58%,68,53,29,150,75%,44,31,28,103,52%,737,61%,kinesthetic,2,Join study group
ST-401,48,23,71,36%,21,32,46,99,50%,50,35,39,124,62%,23,55,26,104,52%,22,68,30,120,60%,42,20,22,84,42%,602,50%,kinesthetic,3,Practice regularly
ST-402,81,80,161,81%,25,72,58,155,78%,22,32,46,100,50%,29,63,39,131,66%,40,47,32,119,60%,42,22,27,91,46%,757,63%,kinesthetic,3,Ask questions
ST-403,90,87,177,89%,38,65,25,128,64%,40,27,74,141,71%,75,78,29,182,91%,58,21,25,104,52%,21,74,39,134,67%,866,72%,visual,1,Practice regularly
ST-404,75,36,111,56%,40,35,76,151,76%,59,62,55,176,88%,56,60,25,141,71%,73,51,24,148,74%,53,25,30,108,54%,835,70%,kinesthetic,1,Practice regularly
ST-405,76,93,169,85%,47,27,76,150,75%,25,67,69,161,81%,45,71,22,138,69%,67,32,29,128,64%,57,31,26,114,57%,860,72%,visual,4,Practice regularly
ST-406,37,33,70,35%,47,36,49,132,66%,48,50,51,149,75%,22,30,29,81,41%,47,26,34,107,54%,25,39,22,86,43%,625,52%,visual,3,Join study group
ST-407,88,32,120,60%,28,22,31,81,41%,33,67,34,134,67%,34,48,33,115,58%,71,78,24,173,87%,46,76,31,153,77%,776,65%,kinesthetic,1,Practice regularly
ST-408,60,43,103,52%,34,30,33,97,49%,26,57,74,157,79%,51,51,23,125,63%,52,21,21,94,47%,30,41,27,98,49%,674,56%,kinesthetic,5,Ask questions
ST-409,28,24,52,26%,34,23,35,92,46%,31,60,56,147,74%,68,22,32,122,61%,63,37,32,132,66%,47,69,30,146,73%,691,58%,auditory,2,Join study group
ST-410,83,23,106,53%,49,49,42,140,70%,24,22,23,69,35%,20,58,37,115,58%,21,59,37,117,59%,73,43,32,148,74%,695,58%,auditory,3,Practice regularly
ST-411,82,91,173,87%,32,47,64,143,72%,22,21,59,102,51%,43,27,27,97,49%,32,41,27,100,50%,79,29,24,132,66%,747,62%,visual,4,Join study group
ST-412,52,43,95,48%,30,38,70,138,69%,29,57,70,156,78%,26,48,33,107,54%,40,40,36,116,58%,76,51,33,160,80%,772,64%,kinesthetic,5,Join study group
ST-413,29,53,82,41%,48,35,31,114,57%,55,21,20,96,48%,56,26,35,117,59%,23,31,23,77,39%,31,52,32,115,58%,601,50%,kinesthetic,3,Ask questions
ST-414,65,55,120,60%,28,66,62,156,78%,28,38,68,134,67%,76,53,26,155,78%,56,58,29,143,72%,50,23,36,109,55%,817,68%,auditory,3,Ask questions
ST-415,26,72,98,49%,49,59,63,171,86%,52,38,35,125,63%,30,46,24,100,50%,62,35,25,122,61%,73,77,22,172,86%,788,66%,auditory,3,Ask questions
ST-416,38,68,106,53%,53,68,77,198,99%,53,26,40,119,60%,56,35,25,116,58%,32,67,20,119,60%,61,30,33,124,62%,782,65%,auditory,5,Practice regularly
ST-417,80,62,142,71%,20,69,38,127,64%,32,74,78,184,92%,56,54,32,142,71%,46,42,35,123,62%,48,27,39,114,57%,832,69%,kinesthetic,1,Practice regularly
ST-418,93,76,169,85%,49,64,40,153,77%,43,37,22,102,51%,62,45,33,140,70%,41,59,26,126,63%,77,33,33,143,72%,833,69%,auditory,2,Join study group
ST-419,85,45,130,65%,33,74,40,147,74%,46,62,46,154,77%,20,67,20,107,54%,66,30,22,118,59%,29,59,32,120,60%,776,65%,visual,2,Ask questions
ST-420,23,63,86,43%,59,51,65,175,88%,24,36,34,94,47%,54,64,30,148,74%,28,32,22,82,41%,26,39,39,104,52%,689,57%,auditory,5,Ask questions
ST-421,32,77,109,55%,34,40,24,98,49%,57,64,26,147,74%,46,36,23,105,53%,20,51,29,100,50%,60,60,37,157,79%,716,60%,auditory,1,Practice regularly
ST-422,93,89,182,91%,24,38,21,83,42%,22,40,21,83,42%,41,66,28,135,68%,74,74,32,180,90%,78,38,29,145,73%,808,67%,auditory,1,Join study group
ST-423,59,95,154,77%,36,57,57,150,75%,30,47,36,113,57%,28,59,22,109,55%,39,67,25,131,66%,42,61,30,133,67%,790,66%,auditory,4,Practice regularly
ST-424,50,49,99,50%,48,30,44,122,61%,26,46,32,104,52%,53,63,22,138,69%,76,44,26,146,73%,37,32,31,100,50%,709,59%,auditory,3,Study more
ST-425,71,79,150,75%,56,40,45,141,71%,48,50,65,163,82%,47,79,24,150,75%,20,62,37,119,60%,77,47,28,152,76%,875,73%,kinesthetic,2,Join study group
ST-426,53,92,145,73%,38,37,31,106,53%,40,74,47,161,81%,28,70,33,131,66%,38,78,27,143,72%,58,20,33,111,56%,797,66%,kinesthetic,5,Join study group
ST-427,27,44,71,36%,57,67,51,175,88%,55,62,32,149,75%,26,59,33,118,59%,36,72,21,129,65%,44,69,39,152,76%,794,66%,visual,3,Ask questions
ST-428,46,93,139,70%,43,57,66,166,83%,20,37,50,107,54%,24,46,33,103,52%,57,76,23,156,78%,41,79,33,153,77%,824,69%,auditory,5,Ask questions
ST-429,53,97,150,75%,52,72,21,145,73%,48,33,68,149,75%,32,66,23,121,61%,37,46,23,106,53%,34,68,20,122,61%,793,66%,auditory,3,Join study group
ST-430,48,68,116,58%,39,68,21,128,64%,58,64,43,165,83%,56,30,30,116,58%,21,57,22,100,50%,56,41,23,120,60%,745,62%,auditory,4,Study more
ST-431,36,96,132,66%,39,28,35,102,51%,21,42,53,116,58%,39,44,23,106,53%,57,26,26,109,55%,77,77,21,175,88%,740,62%,visual,5,Study more
ST-432,98,88,186,93%,51,30,46,127,64%,30,34,63,127,64%,50,64,33,147,74%,26,74,23,123,62%,22,27,22,71,36%,781,65%,auditory,3,Ask questions
ST-433,93,49,142,71%,37,59,38,134,67%,21,47,48,116,58%,25,29,36,90,45%,77,41,29,147,74%,59,60,29,148,74%,777,65%,kinesthetic,3,Study more
ST-434,74,47,121,61%,36,40,51,127,64%,52,34,23,109,55%,34,49,39,122,61%,33,61,27,121,61%,77,36,20,133,67%,733,61%,visual,3,Practice regularly
ST-435,22,46,68,34%,33,39,36,108,54%,58,25,53,136,68%,27,66,31,124,62%,38,41,26,105,53%,77,34,29,140,70%,681,57%,visual,1,Join study group
ST-436,77,62,139,70%,20,61,51,132,66%,58,75,65,198,99%,28,74,25,127,64%,36,51,23,110,55%,56,46,38,140,70%,846,71%,auditory,1,Ask questions
ST-437,99,80,179,90%,57,36,23,116,58%,36,24,45,105,53%,34,79,32,145,73%,38,40,20,98,49%,72,48,26,146,73%,789,66%,auditory,1,Join study group
ST-438,35,35,70,35%,50,43,69,162,81%,24,36,59,119,60%,26,21,23,70,35%,56,51,20,127,64%,45,34,29,108,54%,656,55%,auditory,5,Practice regularly
ST-439,21,60,81,41%,49,66,51,166,83%,56,22,39,117,59%,52,68,30,150,75%,76,40,36,152,76%,79,79,20,178,89%,844,70%,auditory,4,Join study group
ST-440,30,95,125,63%,25,26,63,114,57%,28,38,31,97,49%,39,44,22,105,53%,60,64,38,162,81%,24,20,20,64,32%,667,56%,auditory,2,Join study group
ST-441,59,80,139,70%,29,36,57,122,61%,36,40,43,119,60%,50,42,35,127,64%,74,44,22,140,70%,79,39,27,145,73%,792,66%,kinesthetic,2,Join study group
ST-442,93,76,169,85%,39,57,59,155,78%,38,23,55,116,58%,59,63,32,154,77%,35,39,24,98,49%,48,42,27,117,59%,809,67%,kinesthetic,2,Study more
ST-443,74,37,111,56%,24,56,75,155,78%,59,35,22,116,58%,29,52,25,106,53%,43,46,21,110,55%,67,39,31,137,69%,735,61%,visual,2,Ask questions
ST-444,94,62,156,78%,38,41,53,132,66%,45,30,75,150,75%,76,39,22,137,69%,39,28,21,88,44%,52,40,20,112,56%,775,65%,kinesthetic,4,Practice regularly
ST-445,75,45,120,60%,45,71,59,175,88%,45,79,57,181,91%,36,72,23,131,66%,74,35,28,137,69%,34,59,37,130,65%,874,73%,kinesthetic,1,Study more
ST-446,32,86,118,59%,53,79,49,181,91%,52,57,61,170,85%,41,55,36,132,66%,77,78,25,180,90%,73,34,39,146,73%,927,77%,kinesthetic,1,Practice regularly
ST-447,56,77,133,67%,50,25,65,140,70%,46,61,68,175,88%,24,30,20,74,37%,79,41,30,150,75%,42,44,35,121,61%,793,66%,auditory,3,Ask questions
ST-448,62,99,161,81%,37,32,62,131,66%,43,63,56,162,81%,54,42,24,120,60%,79,67,35,181,91%,33,23,24,80,40%,835,70%,auditory,4,Study more
ST-449,52,53,105,53%,44,25,59,128,64%,45,52,34,131,66%,20,77,35,132,66%,28,45,37,110,55%,42,68,27,137,69%,743,62%,kinesthetic,4,Join study group
ST-450,67,26,93,47%,57,51,31,139,70%,27,20,62,109,55%,56,24,23,103,52%,66,52,26,144,72%,33,30,37,100,50%,688,57%,auditory,5,Study more
ST-451,67,63,130,65%,33,42,37,112,56%,31,36,43,110,55%,68,49,26,143,72%,71,64,31,166,83%,60,28,36,124,62%,785,65%,kinesthetic,5,Ask questions
ST-452,83,34,117,59%,48,31,23,102,51%,53,69,55,177,89%,70,36,27,133,67%,76,77,33,186,93%,75,39,22,136,68%,851,71%,auditory,3,Ask questions
ST-453,54,99,153,77%,33,44,34,111,56%,53,51,50,154,77%,31,27,36,94,47%,41,41,30,112,56%,29,71,20,120,60%,744,62%,kinesthetic,2,Practice regularly
ST-454,91,87,178,89%,48,38,38,124,62%,36,62,36,134,67%,37,68,25,130,65%,77,70,21,168,84%,61,77,26,164,82%,898,75%,visual,3,Join study group
ST-455,79,62,141,71%,44,72,48,164,82%,22,59,38,119,60%,77,40,34,151,76%,61,42,21,124,62%,70,59,25,154,77%,853,71%,auditory,5,Ask questions
ST-456,40,76,116,58%,27,26,34,87,44%,43,68,25,136,68%,23,30,36,89,45%,35,49,20,104,52%,68,49,28,145,73%,677,56%,visual,1,Ask questions
ST-457,24,47,71,36%,37,55,57,149,75%,52,51,25,128,64%,77,20,26,123,62%,62,79,37,178,89%,47,63,29,139,70%,788,66%,kinesthetic,5,Ask questions
ST-458,96,30,126,63%,46,68,46,160,80%,59,59,55,173,87%,56,70,31,157,79%,38,69,29,136,68%,68,50,25,143,72%,895,75%,kinesthetic,5,Ask questions
ST-459,49,56,105,53%,54,60,50,164,82%,38,79,56,173,87%,30,56,38,124,62%,28,75,36,139,70%,31,45,31,107,54%,812,68%,kinesthetic,1,Join study group
ST-460,94,67,161,81%,26,53,20,99,50%,56,22,60,138,69%,20,43,33,96,48%,57,32,39,128,64%,62,23,20,105,53%,727,61%,auditory,5,Study more
ST-461,80,25,105,53%,54,47,45,146,73%,39,48,61,148,74%,49,54,27,130,65%,46,62,31,139,70%,24,45,21,90,45%,758,63%,visual,3,Ask questions
ST-462,43,27,70,35%,49,20,61,130,65%,24,69,75,168,84%,70,61,39,170,85%,26,31,30,87,44%,55,31,38,124,62%,749,62%,auditory,4,Practice regularly
ST-463,30,36,66,33%,58,67,54,179,90%,43,24,62,129,65%,49,50,30,129,65%,29,57,28,114,57%,56,42,31,129,65%,746,62%,auditory,2,Study more
ST-464,78,73,151,76%,56,40,28,124,62%,40,34,54,128,64%,29,63,36,128,64%,77,54,32,163,82%,48,67,30,145,73%,839,70%,kinesthetic,4,Join study group
ST-465,32,71,103,52%,33,49,42,124,62%,29,22,76,127,64%,25,20,26,71,36%,20,54,39,113,57%,33,38,32,103,52%,641,53%,auditory,2,Ask questions
ST-466,89,56,145,73%,54,23,59,136,68%,53,24,54,131,66%,29,51,31,111,56%,74,61,38,173,87%,44,23,34,101,51%,797,66%,visual,1,Ask questions
ST-467,67,92,159,80%,28,47,56,131,66%,57,27,51,135,68%,37,70,35,142,71%,27,78,36,141,71%,47,28,20,95,48%,803,67%,kinesthetic,5,Practice regularly
ST-468,68,36,104,52%,44,60,70,174,87%,59,33,50,142,71%,72,75,36,183,92%,63,46,30,139,70%,63,24,30,117,59%,859,72%,auditory,4,Practice regularly
ST-469,84,25,109,55%,32,31,34,97,49%,47,28,70,145,73%,20,77,30,127,64%,43,52,25,120,60%,79,26,35,140,70%,738,62%,visual,5,Join study group
ST-470,53,64,117,59%,44,53,56,153,77%,22,70,49,141,71%,52,38,27,117,59%,23,75,21,119,60%,20,30,36,86,43%,733,61%,kinesthetic,2,Ask questions
ST-471,52,88,140,70%,33,54,37,124,62%,32,33,25,90,45%,60,75,32,167,84%,57,25,30,112,56%,21,60,38,119,60%,752,63%,kinesthetic,2,Study more
ST-472,42,62,104,52%,47,50,72,169,85%,35,63,65,163,82%,66,35,24,125,63%,40,39,27,106,53%,72,43,33,148,74%,815,68%,kinesthetic,1,Practice regularly
ST-473,36,69,105,53%,59,41,24,124,62%,35,63,51,149,75%,42,33,23,98,49%,50,32,22,104,52%,76,32,32,140,70%,720,60%,auditory,1,Ask questions
ST-474,24,22,46,23%,34,31,45,110,55%,34,47,29,110,55%,41,78,26,145,73%,71,28,33,132,66%,49,48,20,117,59%,660,55%,visual,1,Study more
ST-475,37,65,102,51%,35,54,50,139,70%,34,47,41,122,61%,43,43,32,118,59%,32,53,37,122,61%,21,29,30,80,40%,683,57%,kinesthetic,1,Practice regularly
ST-476,27,24,51,26%,50,74,50,174,87%,36,62,44,142,71%,47,26,21,94,47%,72,39,32,143,72%,49,23,30,102,51%,706,59%,kinesthetic,2,Ask questions
ST-477,91,20,111,56%,40,41,63,144,72%,45,30,74,149,75%,50,62,21,133,67%,24,54,27,105,53%,38,64,33,135,68%,777,65%,visual,3,Practice regularly
ST-478,90,83,173,87%,33,22,35,90,45%,20,34,74,128,64%,79,62,39,180,90%,56,44,32,132,66%,55,66,36,157,79%,860,72%,kinesthetic,1,Study more
ST-479,79,85,164,82%,57,56,50,163,82%,29,29,62,120,60%,69,53,33,155,78%,74,60,20,154,77%,26,31,34,91,46%,847,71%,visual,1,Ask questions
ST-480,73,51,124,62%,20,24,33,77,39%,25,77,35,137,69%,61,78,21,160,80%,50,30,30,110,55%,75,37,39,151,76%,759,63%,visual,1,Ask questions
ST-481,86,55,141,71%,31,68,34,133,67%,33,44,78,155,78%,68,67,22,157,79%,50,33,37,120,60%,70,49,27,146,73%,852,71%,kinesthetic,4,Join study group
ST-482,87,29,116,58%,53,76,62,191,96%,51,74,68,193,97%,23,53,25,101,51%,23,26,33,82,41%,44,75,23,142,71%,825,69%,visual,2,Practice regularly
ST-483,44,36,80,40%,56,61,61,178,89%,34,68,57,159,80%,41,52,33,126,63%,42,79,24,145,73%,23,70,29,122,61%,810,68%,visual,1,Study more
ST-484,33,23,56,28%,33,56,36,125,63%,53,53,79,185,93%,25,49,23,97,49%,50,35,24,109,55%,75,77,32,184,92%,756,63%,visual,5,Join study group
ST-485,64,38,102,51%,32,22,54,108,54%,40,32,40,112,56%,64,66,39,169,85%,55,38,20,113,57%,60,37,26,123,62%,727,61%,kinesthetic,1,Join study group
ST-486,60,81,141,71%,23,35,44,102,51%,51,72,44,167,84%,24,35,34,93,47%,20,49,32,101,51%,66,21,34,121,61%,725,60%,visual,1,Join study group
ST-487,84,60,144,72%,38,67,79,184,92%,37,65,29,131,66%,23,49,33,105,53%,77,77,39,193,97%,61,38,28,127,64%,884,74%,auditory,3,Practice regularly
ST-488,80,86,166,83%,38,39,38,115,58%,22,73,37,132,66%,39,75,32,146,73%,24,42,21,87,44%,33,22,37,92,46%,738,62%,auditory,4,Join study group
ST-489,98,60,158,79%,32,66,46,144,72%,57,56,34,147,74%,52,55,39,146,73%,67,73,32,172,86%,21,38,39,98,49%,865,72%,visual,2,Practice regularly
ST-490,54,33,87,44%,54,51,24,129,65%,59,66,70,195,98%,78,21,21,120,60%,57,22,25,104,52%,22,31,22,75,38%,710,59%,kinesthetic,3,Study more
ST-491,31,85,116,58%,25,23,23,71,36%,54,53,49,156,78%,30,69,20,119,60%,74,27,24,125,63%,30,79,27,136,68%,723,60%,kinesthetic,2,Practice regularly
ST-492,39,35,74,37%,46,23,51,120,60%,54,27,74,155,78%,27,39,34,100,50%,49,21,36,106,53%,63,34,33,130,65%,685,57%,kinesthetic,1,Study more
ST-493,75,59,134,67%,22,30,26,78,39%,21,23,58,102,51%,32,65,31,128,64%,37,52,39,128,64%,32,54,29,115,58%,685,57%,auditory,2,Ask questions
ST-494,70,24,94,47%,23,52,39,114,57%,40,78,22,140,70%,77,67,32,176,88%,63,72,32,167,84%,38,62,27,127,64%,818,68%,visual,3,Study more
ST-495,51,78,129,65%,58,29,72,159,80%,57,65,22,144,72%,27,57,28,112,56%,54,48,33,135,68%,55,32,25,112,56%,791,66%,auditory,4,Ask questions
ST-496,59,44,103,52%,45,28,39,112,56%,32,30,72,134,67%,35,51,29,115,58%,24,24,39,87,44%,40,47,34,121,61%,672,56%,kinesthetic,1,Practice regularly
ST-497,72,50,122,61%,36,73,35,144,72%,32,58,35,125,63%,41,68,28,137,69%,42,36,22,100,50%,44,35,34,113,57%,741,62%,auditory,3,Practice regularly
ST-498,49,70,119,60%,44,41,37,122,61%,40,37,70,147,74%,24,59,23,106,53%,25,33,20,78,39%,24,33,22,79,40%,651,54%,visual,5,Study more
ST-499,81,84,165,83%,23,41,38,102,51%,29,28,52,109,55%,59,48,21,128,64%,76,26,31,133,67%,44,78,24,146,73%,783,65%,auditory,2,Study more
ST-500,37,94,131,66%,49,56,27,132,66%,53,26,68,147,74%,26,24,22,72,36%,62,58,30,150,75%,23,25,32,80,40%,712,59%,kinesthetic,4,Join study group
ST-501,61,87,148,74%,59,75,21,155,78%,31,52,52,135,68%,57,44,23,124,62%,72,61,23,156,78%,49,30,29,108,54%,826,69%,visual,2,Practice regularly
ST-502,75,85,160,80%,32,22,35,89,45%,23,58,66,147,74%,53,67,24,144,72%,71,39,26,136,68%,78,34,38,150,75%,826,69%,kinesthetic,2,Study more
ST-503,67,22,89,45%,31,73,62,166,83%,28,27,53,108,54%,78,55,38,171,86%,59,29,24,112,56%,78,58,30,166,83%,812,68%,visual,3,Study more
ST-504,45,52,97,49%,54,76,73,203,102%,38,40,75,153,77%,37,21,32,90,45%,41,35,30,106,53%,61,22,39,122,61%,771,64%,kinesthetic,4,Join study group
ST-505,60,75,135,68%,33,69,62,164,82%,57,63,60,180,90%,58,79,24,161,81%,78,52,27,157,79%,46,62,29,137,69%,934,78%,visual,4,Practice regularly
ST-506,88,49,137,69%,30,31,49,110,55%,38,23,40,101,51%,44,63,33,140,70%,48,45,27,120,60%,33,58,22,113,57%,721,60%,visual,3,Join study group
ST-507,38,81,119,60%,36,26,23,85,43%,30,69,42,141,71%,53,57,25,135,68%,21,35,32,88,44%,50,76,31,157,79%,725,60%,auditory,2,Practice regularly
ST-508,44,93,137,69%,22,32,55,109,55%,25,69,72,166,83%,35,48,27,110,55%,62,47,21,130,65%,44,36,38,118,59%,770,64%,kinesthetic,1,Join study group
ST-509,93,25,118,59%,58,55,37,150,75%,39,40,57,136,68%,36,44,28,108,54%,60,53,23,136,68%,57,37,29,123,62%,771,64%,kinesthetic,4,Study more
ST-510,86,20,106,53%,36,39,50,125,63%,54,71,44,169,85%,23,59,33,115,58%,30,66,34,130,65%,58,22,26,106,53%,751,63%,visual,3,Ask questions
ST-511,38,35,73,37%,22,51,32,105,53%,59,32,37,128,64%,46,75,23,144,72%,60,62,28,150,75%,63,66,27,156,78%,756,63%,visual,4,Ask questions
ST-512,50,85,135,68%,35,68,48,151,76%,27,33,24,84,42%,36,49,32,117,59%,72,24,28,124,62%,70,57,39,166,83%,777,65%,visual,3,Ask questions
ST-513,22,70,92,46%,25,51,36,112,56%,40,57,56,153,77%,76,27,38,141,71%,63,26,25,114,57%,32,73,24,129,65%,741,62%,auditory,2,Join study group
ST-514,76,68,144,72%,26,57,53,136,68%,38,62,59,159,80%,49,29,37,115,58%,30,21,25,76,38%,68,45,22,135,68%,765,64%,visual,2,Join study group
ST-515,46,44,90,45%,37,47,25,109,55%,33,29,69,131,66%,74,69,29,172,86%,49,40,31,120,60%,56,66,37,159,80%,781,65%,visual,3,Ask questions
ST-516,32,25,57,29%,42,25,29,96,48%,20,33,32,85,43%,79,37,22,138,69%,43,69,30,142,71%,79,52,32,163,82%,681,57%,kinesthetic,5,Practice regularly
ST-517,61,42,103,52%,26,36,79,141,71%,58,58,20,136,68%,47,32,33,112,56%,52,25,38,115,58%,76,40,36,152,76%,759,63%,kinesthetic,5,Study more
ST-518,90,86,176,88%,36,44,33,113,57%,42,79,46,167,84%,21,75,33,129,65%,44,64,23,131,66%,57,51,22,130,65%,846,71%,visual,1,Ask questions
ST-519,63,81,144,72%,28,75,51,154,77%,50,64,59,173,87%,20,33,30,83,42%,31,25,33,89,45%,22,45,32,99,50%,742,62%,auditory,4,Ask questions
ST-520,20,51,71,36%,40,31,37,108,54%,30,69,50,149,75%,51,27,21,99,50%,50,62,24,136,68%,47,71,34,152,76%,715,60%,kinesthetic,1,Study more
ST-521,29,98,127,64%,41,30,47,118,59%,24,22,54,100,50%,29,41,26,96,48%,33,77,22,132,66%,58,35,26,119,60%,692,58%,kinesthetic,3,Study more
ST-522,40,43,83,42%,32,45,50,127,64%,42,39,35,116,58%,29,53,28,110,55%,20,63,33,116,58%,26,63,22,111,56%,663,55%,kinesthetic,4,Join study group
ST-523,52,37,89,45%,32,59,38,129,65%,30,42,53,125,63%,33,20,22,75,38%,39,21,23,83,42%,51,43,37,131,66%,632,53%,auditory,3,Practice regularly
ST-524,46,60,106,53%,53,21,72,146,73%,35,60,21,116,58%,31,78,32,141,71%,31,24,35,90,45%,45,24,24,93,47%,692,58%,auditory,1,Ask questions
ST-525,87,70,157,79%,24,50,42,116,58%,42,74,26,142,71%,65,41,30,136,68%,21,53,31,105,53%,67,75,39,181,91%,837,70%,kinesthetic,1,Ask questions
ST-526,55,32,87,44%,28,55,39,122,61%,31,69,40,140,70%,56,60,30,146,73%,76,48,35,159,80%,50,30,23,103,52%,757,63%,auditory,2,Ask questions
ST-527,79,94,173,87%,43,77,46,166,83%,20,72,35,127,64%,39,74,32,145,73%,25,48,37,110,55%,40,58,20,118,59%,839,70%,auditory,1,Ask questions
ST-528,88,64,152,76%,38,47,48,133,67%,59,21,42,122,61%,54,29,27,110,55%,28,54,31,113,57%,55,34,29,118,59%,748,62%,kinesthetic,1,Ask questions
ST-529,20,22,42,21%,54,71,32,157,79%,57,64,79,200,100%,43,62,24,129,65%,60,37,22,119,60%,79,25,36,140,70%,787,66%,kinesthetic,3,Study more
ST-530,74,98,172,86%,25,53,58,136,68%,21,76,28,125,63%,45,48,30,123,62%,34,26,22,82,41%,67,44,34,145,73%,783,65%,kinesthetic,4,Study more
ST-531,39,28,67,34%,32,75,30,137,69%,26,23,73,122,61%,67,65,25,157,79%,35,70,26,131,66%,67,78,34,179,90%,793,66%,kinesthetic,3,Practice regularly
ST-532,97,65,162,81%,27,41,58,126,63%,25,30,51,106,53%,57,29,22,108,54%,38,60,28,126,63%,77,33,30,140,70%,768,64%,visual,5,Ask questions
ST-533,51,58,109,55%,56,39,48,143,72%,26,53,55,134,67%,72,53,36,161,81%,53,73,27,153,77%,62,54,25,141,71%,841,70%,auditory,4,Join study group
ST-534,58,66,124,62%,53,47,41,141,71%,42,53,58,153,77%,64,23,35,122,61%,56,22,23,101,51%,34,55,37,126,63%,767,64%,visual,2,Ask questions
ST-535,40,68,108,54%,42,60,68,170,85%,27,31,76,134,67%,70,77,27,174,87%,23,42,39,104,52%,36,56,22,114,57%,804,67%,kinesthetic,5,Study more
ST-536,49,20,69,35%,59,33,75,167,84%,48,43,30,121,61%,70,40,21,131,66%,25,55,22,102,51%,53,63,20,136,68%,726,61%,kinesthetic,1,Join study group
ST-537,54,68,122,61%,23,44,41,108,54%,28,34,79,141,71%,57,75,28,160,80%,49,25,26,100,50%,76,52,29,157,79%,788,66%,kinesthetic,4,Study more
ST-538,47,77,124,62%,29,45,54,128,64%,21,52,55,128,64%,65,36,32,133,67%,45,52,22,119,60%,57,51,38,146,73%,778,65%,visual,3,Practice regularly
ST-539,92,37,129,65%,29,22,48,99,50%,30,78,29,137,69%,24,43,21,88,44%,72,41,36,149,75%,75,25,34,134,67%,736,61%,visual,5,Ask questions
ST-540,84,43,127,64%,30,74,43,147,74%,31,34,63,128,64%,57,37,25,119,60%,67,49,30,146,73%,65,30,29,124,62%,791,66%,auditory,2,Practice regularly
ST-541,44,31,75,38%,39,38,21,98,49%,21,57,20,98,49%,36,38,33,107,54%,76,79,29,184,92%,46,22,30,98,49%,660,55%,visual,4,Ask questions
ST-542,71,96,167,84%,42,77,20,139,70%,41,40,20,101,51%,44,64,38,146,73%,56,68,35,159,80%,71,23,38,132,66%,844,70%,auditory,5,Ask questions
ST-543,84,73,157,79%,36,39,36,111,56%,26,68,53,147,74%,69,50,33,152,76%,35,35,35,105,53%,63,71,31,165,83%,837,70%,kinesthetic,3,Practice regularly
ST-544,74,90,164,82%,37,21,53,111,56%,27,29,60,116,58%,72,35,35,142,71%,28,27,26,81,41%,64,63,22,149,75%,763,64%,kinesthetic,5,Practice regularly
ST-545,73,29,102,51%,35,64,69,168,84%,23,32,56,111,56%,47,22,31,100,50%,39,71,38,148,74%,70,41,23,134,67%,763,64%,visual,3,Study more
ST-546,37,53,90,45%,54,28,39,121,61%,36,43,71,150,75%,58,48,34,140,70%,50,55,37,142,71%,47,38,39,124,62%,767,64%,visual,3,Ask questions
ST-547,94,62,156,78%,59,62,57,178,89%,45,44,73,162,81%,79,38,26,143,72%,42,41,32,115,58%,75,49,21,145,73%,899,75%,visual,1,Join study group
ST-548,70,50,120,60%,23,32,60,115,58%,21,44,20,85,43%,75,69,28,172,86%,52,30,25,107,54%,79,24,39,142,71%,741,62%,visual,2,Join study group
ST-549,33,34,67,34%,59,30,41,130,65%,39,60,62,161,81%,72,45,28,145,73%,23,27,35,85,43%,41,43,34,118,59%,706,59%,auditory,2,Join study group
ST-550,31,80,111,56%,45,55,20,120,60%,53,64,32,149,75%,69,49,34,152,76%,28,27,26,81,41%,74,23,35,132,66%,745,62%,kinesthetic,4,Practice regularly
ST-551,24,88,112,56%,50,55,73,178,89%,29,65,60,154,77%,30,23,29,82,41%,48,75,21,144,72%,22,23,21,66,33%,736,61%,kinesthetic,5,Study more
ST-552,66,32,98,49%,49,59,69,177,89%,51,48,69,168,84%,70,53,34,157,79%,63,54,33,150,75%,46,57,26,129,65%,879,73%,auditory,4,Practice regularly
ST-553,89,64,153,77%,35,56,35,126,63%,29,57,63,149,75%,30,69,22,121,61%,67,70,26,163,82%,79,48,26,153,77%,865,72%,visual,2,Study more
ST-554,95,30,125,63%,45,34,24,103,52%,52,21,62,135,68%,43,33,35,111,56%,57,32,38,127,64%,76,41,23,140,70%,741,62%,kinesthetic,5,Practice regularly
ST-555,24,40,64,32%,33,76,46,155,78%,28,43,53,124,62%,49,29,23,101,51%,66,36,28,130,65%,38,61,23,122,61%,696,58%,kinesthetic,5,Practice regularly
ST-556,61,46,107,54%,58,24,67,149,75%,51,22,67,140,70%,28,60,31,119,60%,58,49,35,142,71%,31,29,26,86,43%,743,62%,kinesthetic,1,Ask questions
ST-557,66,59,125,63%,29,59,24,112,56%,29,40,55,124,62%,73,65,36,174,87%,77,78,22,177,89%,49,34,27,110,55%,822,69%,kinesthetic,2,Practice regularly
ST-558,97,36,133,67%,52,44,33,129,65%,38,36,44,118,59%,79,30,36,145,73%,63,54,20,137,69%,54,77,21,152,76%,814,68%,auditory,4,Practice regularly
ST-559,96,77,173,87%,25,43,72,140,70%,34,44,20,98,49%,48,29,35,112,56%,61,52,26,139,70%,35,34,29,98,49%,760,63%,visual,1,Ask questions
ST-560,29,46,75,38%,43,37,29,109,55%,24,32,58,114,57%,34,49,36,119,60%,69,74,32,175,88%,31,50,22,103,52%,695,58%,kinesthetic,2,Practice regularly
ST-561,28,84,112,56%,53,69,71,193,97%,20,21,62,103,52%,66,50,21,137,69%,50,79,28,157,79%,48,27,31,106,53%,808,67%,auditory,1,Join study group
ST-562,31,68,99,50%,51,38,57,146,73%,32,56,61,149,75%,78,56,35,169,85%,71,56,32,159,80%,64,63,34,161,81%,883,74%,kinesthetic,5,Ask questions
ST-563,60,77,137,69%,30,38,45,113,57%,45,69,26,140,70%,34,75,35,144,72%,61,76,39,176,88%,57,26,24,107,54%,817,68%,kinesthetic,1,Ask questions
ST-564,34,34,68,34%,27,60,74,161,81%,49,38,76,163,82%,20,39,39,98,49%,36,44,26,106,53%,53,33,30,116,58%,712,59%,visual,2,Ask questions
ST-565,92,94,186,93%,48,22,53,123,62%,51,28,57,136,68%,65,36,33,134,67%,76,21,20,117,59%,49,60,28,137,69%,833,69%,auditory,5,Practice regularly
ST-566,97,46,143,72%,28,51,47,126,63%,38,44,63,145,73%,33,55,33,121,61%,65,44,20,129,65%,78,20,37,135,68%,799,67%,auditory,2,Study more
ST-567,98,46,144,72%,26,40,20,86,43%,22,57,46,125,63%,47,60,28,135,68%,45,57,34,136,68%,24,66,39,129,65%,755,63%,visual,2,Study more
ST-568,43,72,115,58%,20,55,46,121,61%,48,44,78,170,85%,34,53,37,124,62%,52,61,22,135,68%,43,50,20,113,57%,778,65%,visual,4,Join study group
ST-569,82,25,107,54%,44,36,77,157,79%,27,78,26,131,66%,39,41,35,115,58%,72,49,29,150,75%,71,42,24,137,69%,797,66%,kinesthetic,4,Join study group
ST-570,30,78,108,54%,56,25,35,116,58%,46,76,63,185,93%,27,33,34,94,47%,61,46,27,134,67%,23,38,24,85,43%,722,60%,visual,4,Study more
ST-571,84,81,165,83%,36,67,41,144,72%,36,60,32,128,64%,44,38,25,107,54%,33,41,21,95,48%,29,62,34,125,63%,764,64%,kinesthetic,4,Practice regularly
ST-572,20,96,116,58%,25,69,62,156,78%,51,79,78,208,104%,32,37,23,92,46%,30,49,29,108,54%,62,49,38,149,75%,829,69%,kinesthetic,4,Study more
ST-573,80,78,158,79%,38,39,44,121,61%,47,76,36,159,80%,46,28,38,112,56%,21,42,35,98,49%,63,72,35,170,85%,818,68%,auditory,1,Practice regularly
ST-574,62,42,104,52%,28,53,34,115,58%,53,74,70,197,99%,76,32,33,141,71%,50,40,22,112,56%,65,56,25,146,73%,815,68%,visual,3,Join study group
ST-575,97,49,146,73%,38,38,73,149,75%,48,53,50,151,76%,38,77,27,142,71%,33,43,30,106,53%,45,22,29,96,48%,790,66%,kinesthetic,2,Join study group
ST-576,67,65,132,66%,34,67,70,171,86%,51,63,61,175,88%,23,60,32,115,58%,22,31,36,89,45%,69,73,32,174,87%,856,71%,visual,3,Study more
ST-577,76,93,169,85%,43,25,26,94,47%,52,55,66,173,87%,44,25,31,100,50%,44,56,31,131,66%,78,46,26,150,75%,817,68%,visual,5,Join study group
ST-578,41,85,126,63%,50,72,24,146,73%,55,65,30,150,75%,41,46,31,118,59%,33,24,38,95,48%,30,23,30,83,42%,718,60%,auditory,5,Ask questions
ST-579,43,70,113,57%,27,72,45,144,72%,25,50,55,130,65%,62,62,25,149,75%,25,59,22,106,53%,53,53,26,132,66%,774,65%,auditory,4,Study more
ST-580,38,57,95,48%,45,48,42,135,68%,24,78,24,126,63%,45,78,27,150,75%,25,79,24,128,64%,59,34,35,128,64%,762,64%,visual,1,Study more
ST-581,78,90,168,84%,56,50,71,177,89%,25,29,72,126,63%,64,55,36,155,78%,57,20,33,110,55%,65,65,39,169,85%,905,75%,visual,1,Practice regularly
ST-582,88,72,160,80%,46,40,22,108,54%,39,27,52,118,59%,67,48,33,148,74%,35,29,33,97,49%,47,55,25,127,64%,758,63%,visual,3,Join study group
ST-583,29,49,78,39%,40,25,77,142,71%,33,25,28,86,43%,33,55,33,121,61%,45,31,36,112,56%,62,62,33,157,79%,696,58%,auditory,2,Study more
ST-584,72,44,116,58%,21,50,72,143,72%,32,67,20,119,60%,26,66,25,117,59%,55,28,26,109,55%,33,76,33,142,71%,746,62%,auditory,4,Practice regularly
ST-585,52,73,125,63%,49,32,78,159,80%,31,49,31,111,56%,30,78,27,135,68%,20,78,29,127,64%,44,42,24,110,55%,767,64%,auditory,3,Practice regularly
ST-586,88,65,153,77%,41,64,47,152,76%,58,76,51,185,93%,65,72,26,163,82%,59,20,32,111,56%,35,54,39,128,64%,892,74%,auditory,4,Study more
ST-587,22,86,108,54%,22,46,75,143,72%,52,73,34,159,80%,63,60,39,162,81%,63,25,24,112,56%,34,63,36,133,67%,817,68%,kinesthetic,4,Ask questions
ST-588,75,47,122,61%,30,76,39,145,73%,30,21,41,92,46%,63,57,24,144,72%,63,23,20,106,53%,59,23,32,114,57%,723,60%,auditory,4,Study more
ST-589,50,76,126,63%,53,31,74,158,79%,28,53,21,102,51%,70,56,22,148,74%,21,45,21,87,44%,46,22,29,97,49%,718,60%,kinesthetic,5,Join study group
ST-590,57,26,83,42%,24,28,71,123,62%,20,43,76,139,70%,26,62,23,111,56%,61,29,30,120,60%,44,24,25,93,47%,669,56%,auditory,1,Practice regularly
ST-591,98,39,137,69%,28,33,72,133,67%,50,32,44,126,63%,72,56,28,156,78%,54,36,35,125,63%,42,68,37,147,74%,824,69%,visual,4,Ask questions
ST-592,26,76,102,51%,47,35,21,103,52%,58,66,57,181,91%,56,61,28,145,73%,65,76,23,164,82%,48,59,32,139,70%,834,70%,kinesthetic,5,Join study group
ST-593,20,63,83,42%,58,58,48,164,82%,59,49,72,180,90%,53,36,24,113,57%,58,57,27,142,71%,38,20,36,94,47%,776,65%,auditory,2,Practice regularly
ST-594,71,43,114,57%,41,70,34,145,73%,50,45,70,165,83%,60,38,27,125,63%,47,57,20,124,62%,73,37,28,138,69%,811,68%,visual,5,Practice regularly
ST-595,94,45,139,70%,53,28,65,146,73%,38,35,74,147,74%,66,71,37,174,87%,48,32,22,102,51%,32,52,37,121,61%,829,69%,kinesthetic,1,Study more
ST-596,84,88,172,86%,43,49,55,147,74%,50,37,23,110,55%,41,57,31,129,65%,27,49,23,99,50%,37,33,33,103,52%,760,63%,visual,3,Join study group
ST-597,61,32,93,47%,51,38,45,134,67%,26,27,40,93,47%,57,77,21,155,78%,29,67,21,117,59%,47,31,32,110,55%,702,59%,visual,3,Study more
ST-598,51,74,125,63%,57,76,74,207,104%,21,30,53,104,52%,58,74,32,164,82%,44,78,33,155,78%,59,49,24,132,66%,887,74%,kinesthetic,2,Ask questions
ST-599,44,58,102,51%,29,27,66,122,61%,40,23,43,106,53%,45,61,27,133,67%,24,62,21,107,54%,53,74,36,163,82%,733,61%,kinesthetic,1,Join study group
ST-600,34,72,106,53%,22,32,42,96,48%,59,79,38,176,88%,73,25,22,120,60%,47,70,39,156,78%,50,72,33,155,78%,809,67%,auditory,3,Join study group
ST-601,53,91,144,72%,26,41,24,91,46%,41,22,35,98,49%,34,41,38,113,57%,49,34,22,105,53%,70,67,36,173,87%,724,60%,visual,2,Join study group
ST-602,55,46,101,51%,26,32,47,105,53%,45,54,46,145,73%,28,46,35,109,55%,59,54,34,147,74%,64,68,21,153,77%,760,63%,kinesthetic,2,Ask questions
ST-603,55,28,83,42%,25,75,78,178,89%,53,22,56,131,66%,52,79,34,165,83%,35,56,33,124,62%,41,37,36,114,57%,795,66%,auditory,2,Practice regularly
ST-604,51,41,92,46%,54,53,52,159,80%,44,43,51,138,69%,24,26,23,73,37%,58,64,34,156,78%,26,65,33,124,62%,742,62%,visual,2,Practice regularly
ST-605,29,35,64,32%,34,49,47,130,65%,58,42,58,158,79%,59,65,38,162,81%,72,59,21,152,76%,58,42,28,128,64%,794,66%,auditory,3,Study more
ST-606,86,31,117,59%,53,61,60,174,87%,26,20,42,88,44%,44,67,29,140,70%,52,37,35,124,62%,25,36,24,85,43%,728,61%,auditory,5,Ask questions
ST-607,67,24,91,46%,20,79,24,123,62%,25,27,74,126,63%,52,36,32,120,60%,24,56,35,115,58%,66,77,38,181,91%,756,63%,kinesthetic,2,Practice regularly
ST-608,39,37,76,38%,54,42,20,116,58%,49,46,48,143,72%,59,61,39,159,80%,56,23,21,100,50%,60,61,33,154,77%,748,62%,visual,3,Practice regularly
ST-609,81,34,115,58%,32,24,73,129,65%,24,21,65,110,55%,40,65,30,135,68%,71,34,22,127,64%,38,64,21,123,62%,739,62%,kinesthetic,1,Practice regularly
ST-610,73,22,95,48%,44,63,46,153,77%,51,43,56,150,75%,71,41,32,144,72%,64,43,35,142,71%,39,21,23,83,42%,767,64%,visual,2,Ask questions
ST-611,59,40,99,50%,33,38,44,115,58%,58,54,52,164,82%,52,25,36,113,57%,23,60,37,120,60%,72,35,37,144,72%,755,63%,kinesthetic,2,Practice regularly
ST-612,94,64,158,79%,51,27,76,154,77%,58,35,55,148,74%,30,65,32,127,64%,68,61,31,160,80%,43,60,37,140,70%,887,74%,visual,1,Join study group
ST-613,30,38,68,34%,55,63,78,196,98%,32,44,40,116,58%,59,59,28,146,73%,39,76,33,148,74%,34,24,25,83,42%,757,63%,kinesthetic,3,Study more
ST-614,77,66,143,72%,26,64,57,147,74%,43,24,43,110,55%,68,49,35,152,76%,64,75,39,178,89%,65,77,22,164,82%,894,75%,kinesthetic,5,Join study group
ST-615,39,52,91,46%,49,30,22,101,51%,52,47,51,150,75%,52,68,29,149,75%,62,49,33,144,72%,43,68,38,149,75%,784,65%,auditory,2,Practice regularly
ST-616,43,21,64,32%,25,50,58,133,67%,29,30,71,130,65%,74,35,24,133,67%,50,39,20,109,55%,46,48,35,129,65%,698,58%,auditory,1,Ask questions
ST-617,57,45,102,51%,29,62,49,140,70%,21,66,64,151,76%,66,42,25,133,67%,32,62,38,132,66%,55,69,34,158,79%,816,68%,visual,1,Ask questions
ST-618,60,55,115,58%,20,61,52,133,67%,58,56,62,176,88%,77,48,30,155,78%,78,27,22,127,64%,74,68,22,164,82%,870,73%,kinesthetic,2,Ask questions
ST-619,37,95,132,66%,55,41,31,127,64%,30,29,74,133,67%,57,21,36,114,57%,59,26,21,106,53%,70,24,35,129,65%,741,62%,visual,1,Study more
ST-620,64,88,152,76%,32,45,45,122,61%,31,30,49,110,55%,69,33,38,140,70%,54,26,33,113,57%,53,79,33,165,83%,802,67%,kinesthetic,3,Study more
ST-621,97,67,164,82%,42,69,51,162,81%,37,76,63,176,88%,33,37,30,100,50%,25,38,39,102,51%,53,64,26,143,72%,847,71%,auditory,4,Practice regularly
ST-622,35,83,118,59%,53,70,34,157,79%,21,69,30,120,60%,37,71,37,145,73%,60,68,21,149,75%,56,68,37,161,81%,850,71%,visual,2,Study more
ST-623,75,69,144,72%,49,23,52,124,62%,47,43,44,134,67%,52,23,22,97,49%,72,41,36,149,75%,26,48,32,106,53%,754,63%,auditory,3,Study more
ST-624,85,89,174,87%,45,78,72,195,98%,23,38,78,139,70%,76,63,31,170,85%,21,31,34,86,43%,72,70,34,176,88%,940,78%,kinesthetic,5,Study more
ST-625,30,38,68,34%,53,44,26,123,62%,35,59,56,150,75%,52,78,22,152,76%,52,32,23,107,54%,76,25,37,138,69%,738,62%,kinesthetic,4,Practice regularly
ST-626,93,35,128,64%,40,66,59,165,83%,31,65,39,135,68%,38,36,39,113,57%,45,56,35,136,68%,35,77,22,134,67%,811,68%,auditory,5,Practice regularly
ST-627,43,67,110,55%,20,79,50,149,75%,36,59,31,126,63%,31,41,21,93,47%,66,43,38,147,74%,52,25,20,97,49%,722,60%,visual,3,Join study group
ST-628,50,48,98,49%,38,71,57,166,83%,55,25,47,127,64%,44,64,20,128,64%,71,38,34,143,72%,26,64,20,110,55%,772,64%,kinesthetic,3,Ask questions
ST-629,57,43,100,50%,32,68,79,179,90%,36,24,45,105,53%,65,44,36,145,73%,62,31,29,122,61%,58,62,23,143,72%,794,66%,auditory,4,Practice regularly
ST-630,45,33,78,39%,40,44,32,116,58%,40,56,75,171,86%,33,30,28,91,46%,42,76,32,150,75%,54,71,33,158,79%,764,64%,visual,1,Ask questions
ST-631,51,97,148,74%,32,33,27,92,46%,50,38,65,153,77%,77,69,25,171,86%,49,33,27,109,55%,30,38,31,99,50%,772,64%,auditory,4,Join study group
ST-632,73,31,104,52%,43,56,74,173,87%,55,67,48,170,85%,48,31,22,101,51%,22,68,24,114,57%,60,26,21,107,54%,769,64%,kinesthetic,2,Study more
ST-633,49,96,145,73%,35,21,35,91,46%,40,33,77,150,75%,36,59,38,133,67%,29,56,23,108,54%,29,21,22,72,36%,699,58%,kinesthetic,2,Ask questions
ST-634,36,94,130,65%,23,31,60,114,57%,26,26,26,78,39%,68,68,23,159,80%,21,65,20,106,53%,43,77,33,153,77%,740,62%,visual,4,Study more
ST-635,20,25,45,23%,33,75,64,172,86%,43,72,26,141,71%,39,36,24,99,50%,37,28,38,103,52%,38,37,37,112,56%,672,56%,kinesthetic,1,Join study group
ST-636,89,96,185,93%,36,67,61,164,82%,57,36,24,117,59%,65,58,37,160,80%,48,68,27,143,72%,60,57,29,146,73%,915,76%,visual,4,Ask questions
ST-637,34,30,64,32%,36,43,24,103,52%,51,31,68,150,75%,21,68,20,109,55%,41,37,35,113,57%,37,78,26,141,71%,680,57%,auditory,2,Join study group
ST-638,38,61,99,50%,29,24,77,130,65%,49,57,60,166,83%,67,64,31,162,81%,39,25,30,94,47%,58,59,26,143,72%,794,66%,visual,2,Ask questions
ST-639,28,75,103,52%,48,74,69,191,96%,28,32,61,121,61%,46,79,33,158,79%,43,60,37,140,70%,26,55,35,116,58%,829,69%,auditory,2,Study more
ST-640,86,47,133,67%,28,63,46,137,69%,43,65,47,155,78%,35,69,30,134,67%,70,34,28,132,66%,26,33,20,79,40%,770,64%,auditory,2,Practice regularly
ST-641,50,82,132,66%,39,48,74,161,81%,35,34,35,104,52%,62,66,25,153,77%,63,34,25,122,61%,45,49,38,132,66%,804,67%,auditory,1,Join study group
ST-642,40,71,111,56%,36,29,44,109,55%,21,42,60,123,62%,74,29,34,137,69%,63,48,38,149,75%,39,52,34,125,63%,754,63%,visual,4,Ask questions
ST-643,60,69,129,65%,34,75,21,130,65%,33,74,37,144,72%,75,42,21,138,69%,56,51,28,135,68%,61,58,23,142,71%,818,68%,auditory,2,Practice regularly
ST-644,68,77,145,73%,56,48,79,183,92%,49,62,68,179,90%,64,72,20,156,78%,32,30,29,91,46%,39,39,36,114,57%,868,72%,kinesthetic,4,Practice regularly
ST-645,57,61,118,59%,30,57,46,133,67%,36,46,22,104,52%,26,31,22,79,40%,67,41,27,135,68%,28,50,21,99,50%,668,56%,visual,5,Practice regularly
ST-646,51,30,81,41%,30,77,21,128,64%,59,62,35,156,78%,34,46,30,110,55%,27,45,30,102,51%,27,64,36,127,64%,704,59%,kinesthetic,2,Ask questions
ST-647,46,81,127,64%,21,54,39,114,57%,22,49,74,145,73%,54,56,35,145,73%,74,64,30,168,84%,45,29,32,106,53%,805,67%,kinesthetic,3,Practice regularly
ST-648,32,50,82,41%,26,73,20,119,60%,49,35,38,122,61%,69,47,23,139,70%,72,28,38,138,69%,65,68,38,171,86%,771,64%,visual,3,Study more
ST-649,33,80,113,57%,46,56,43,145,73%,24,51,70,145,73%,34,29,27,90,45%,26,33,28,87,44%,44,20,29,93,47%,673,56%,auditory,1,Practice regularly
ST-650,46,85,131,66%,53,34,44,131,66%,51,59,26,136,68%,59,73,39,171,86%,49,51,23,123,62%,59,56,21,136,68%,828,69%,auditory,5,Ask questions
ST-651,39,32,71,36%,57,21,55,133,67%,40,77,31,148,74%,57,46,30,133,67%,79,34,27,140,70%,61,40,27,128,64%,753,63%,auditory,5,Join study group
ST-652,72,25,97,49%,27,69,23,119,60%,35,35,50,120,60%,74,75,29,178,89%,53,79,35,167,84%,72,27,29,128,64%,809,67%,auditory,2,Ask questions
ST-653,37,79,116,58%,46,43,42,131,66%,28,32,44,104,52%,50,28,33,111,56%,65,69,30,164,82%,70,25,27,122,61%,748,62%,kinesthetic,1,Practice regularly
ST-654,42,95,137,69%,59,21,58,138,69%,36,32,54,122,61%,46,78,22,146,73%,31,72,31,134,67%,67,23,27,117,59%,794,66%,visual,3,Practice regularly
ST-655,80,51,131,66%,49,61,74,184,92%,55,54,37,146,73%,31,79,27,137,69%,35,26,34,95,48%,35,26,33,94,47%,787,66%,auditory,3,Ask questions
ST-656,68,56,124,62%,26,28,65,119,60%,42,63,76,181,91%,26,78,26,130,65%,69,62,29,160,80%,20,53,20,93,47%,807,67%,auditory,1,Practice regularly
ST-657,69,43,112,56%,37,24,23,84,42%,24,72,47,143,72%,33,64,21,118,59%,50,54,36,140,70%,67,51,25,143,72%,740,62%,kinesthetic,5,Ask questions
ST-658,77,84,161,81%,21,60,45,126,63%,52,68,54,174,87%,53,22,26,101,51%,35,28,33,96,48%,44,55,30,129,65%,787,66%,visual,1,Join study group
ST-659,47,49,96,48%,43,53,71,167,84%,49,48,54,151,76%,45,22,34,101,51%,42,75,31,148,74%,43,29,30,102,51%,765,64%,kinesthetic,4,Ask questions
ST-660,66,85,151,76%,22,62,21,105,53%,41,41,75,157,79%,52,69,31,152,76%,67,35,27,129,65%,62,48,38,148,74%,842,70%,kinesthetic,2,Study more
ST-661,84,40,124,62%,49,60,47,156,78%,21,20,26,67,34%,47,60,36,143,72%,70,41,38,149,75%,75,34,38,147,74%,786,66%,kinesthetic,3,Ask questions
ST-662,96,91,187,94%,30,58,25,113,57%,27,32,41,100,50%,24,33,31,88,44%,55,74,31,160,80%,53,38,25,116,58%,764,64%,kinesthetic,4,Ask questions
ST-663,93,39,132,66%,36,60,25,121,61%,27,24,78,129,65%,29,40,31,100,50%,32,69,23,124,62%,79,56,34,169,85%,775,65%,auditory,4,Join study group
ST-664,71,23,94,47%,39,42,26,107,54%,37,37,62,136,68%,71,31,34,136,68%,66,44,22,132,66%,33,48,30,111,56%,716,60%,visual,4,Ask questions
ST-665,49,89,138,69%,20,30,58,108,54%,55,26,51,132,66%,43,56,33,132,66%,55,58,33,146,73%,45,42,35,122,61%,778,65%,visual,1,Join study group
ST-666,61,65,126,63%,25,69,57,151,76%,34,75,73,182,91%,73,20,39,132,66%,53,61,22,136,68%,20,20,22,62,31%,789,66%,auditory,5,Ask questions
ST-667,37,38,75,38%,39,24,66,129,65%,22,31,66,119,60%,72,37,28,137,69%,32,28,39,99,50%,75,59,25,159,80%,718,60%,visual,2,Study more
ST-668,66,57,123,62%,23,59,21,103,52%,46,43,21,110,55%,76,72,31,179,90%,77,74,20,171,86%,52,75,37,164,82%,850,71%,auditory,1,Study more
ST-669,99,37,136,68%,56,64,29,149,75%,36,70,71,177,89%,54,60,37,151,76%,29,69,35,133,67%,73,23,39,135,68%,881,73%,auditory,5,Ask questions
ST-670,84,95,179,90%,42,53,22,117,59%,57,75,73,205,103%,69,29,37,135,68%,68,79,32,179,90%,35,75,30,140,70%,955,80%,kinesthetic,1,Practice regularly
ST-671,77,94,171,86%,22,31,66,119,60%,40,52,79,171,86%,24,27,24,75,38%,50,41,29,120,60%,21,61,20,102,51%,758,63%,visual,5,Ask questions
ST-672,70,69,139,70%,33,33,34,100,50%,48,70,69,187,94%,64,79,33,176,88%,31,51,28,110,55%,77,54,20,151,76%,863,72%,auditory,1,Ask questions
ST-673,83,45,128,64%,25,36,60,121,61%,21,28,48,97,49%,31,71,25,127,64%,66,66,37,169,85%,50,56,22,128,64%,770,64%,kinesthetic,1,Practice regularly
ST-674,71,46,117,59%,50,33,20,103,52%,40,30,58,128,64%,77,20,37,134,67%,21,58,35,114,57%,22,36,30,88,44%,684,57%,auditory,5,Study more
ST-675,36,50,86,43%,46,22,22,90,45%,24,22,62,108,54%,23,48,27,98,49%,65,73,39,177,89%,39,78,28,145,73%,704,59%,auditory,3,Practice regularly
ST-676,60,97,157,79%,24,38,37,99,50%,31,34,66,131,66%,45,37,37,119,60%,20,79,38,137,69%,34,75,30,139,70%,782,65%,kinesthetic,2,Practice regularly
ST-677,64,36,100,50%,47,56,31,134,67%,27,45,40,112,56%,72,53,32,157,79%,33,31,33,97,49%,44,27,21,92,46%,692,58%,kinesthetic,5,Ask questions
ST-678,22,35,57,29%,49,23,66,138,69%,31,63,78,172,86%,76,25,38,139,70%,70,45,27,142,71%,38,31,39,108,54%,756,63%,kinesthetic,2,Join study group
ST-679,74,88,162,81%,58,44,76,178,89%,47,70,64,181,91%,26,32,24,82,41%,54,46,26,126,63%,32,27,24,83,42%,812,68%,visual,3,Join study group
ST-680,20,62,82,41%,23,23,34,80,40%,52,75,25,152,76%,46,58,21,125,63%,49,53,34,136,68%,32,40,31,103,52%,678,57%,kinesthetic,1,Study more
ST-681,34,91,125,63%,36,23,74,133,67%,57,20,67,144,72%,23,54,37,114,57%,71,77,39,187,94%,66,53,33,152,76%,855,71%,auditory,1,Practice regularly
ST-682,37,76,113,57%,50,39,42,131,66%,48,57,53,158,79%,66,46,39,151,76%,51,76,31,158,79%,66,52,23,141,71%,852,71%,visual,1,Study more
ST-683,34,40,74,37%,41,61,73,175,88%,23,20,54,97,49%,51,50,22,123,62%,39,30,36,105,53%,33,57,37,127,64%,701,58%,visual,2,Study more
ST-684,94,70,164,82%,41,79,61,181,91%,28,53,43,124,62%,53,41,27,121,61%,51,55,33,139,70%,79,22,26,127,64%,856,71%,auditory,1,Ask questions
ST-685,97,42,139,70%,50,69,60,179,90%,30,71,25,126,63%,26,75,26,127,64%,77,70,27,174,87%,62,68,20,150,75%,895,75%,kinesthetic,2,Join study group
ST-686,25,48,73,37%,56,67,65,188,94%,30,60,65,155,78%,47,60,37,144,72%,21,31,32,84,42%,36,59,25,120,60%,764,64%,auditory,5,Join study group
ST-687,96,73,169,85%,53,73,38,164,82%,27,43,53,123,62%,53,59,25,137,69%,59,71,21,151,76%,46,38,23,107,54%,851,71%,visual,5,Ask questions
ST-688,28,21,49,25%,41,55,68,164,82%,52,63,65,180,90%,20,53,21,94,47%,66,75,26,167,84%,32,24,20,76,38%,730,61%,auditory,4,Ask questions
ST-689,66,46,112,56%,31,52,71,154,77%,38,47,47,132,66%,49,25,32,106,53%,46,55,31,132,66%,55,43,35,133,67%,769,64%,auditory,4,Practice regularly
ST-690,27,89,116,58%,25,46,79,150,75%,45,73,44,162,81%,54,40,31,125,63%,21,35,25,81,41%,56,43,34,133,67%,767,64%,kinesthetic,4,Practice regularly
ST-691,36,37,73,37%,54,69,66,189,95%,33,57,27,117,59%,54,74,34,162,81%,61,77,38,176,88%,55,32,36,123,62%,840,70%,kinesthetic,3,Ask questions
ST-692,40,96,136,68%,29,40,70,139,70%,21,50,78,149,75%,27,43,33,103,52%,30,29,39,98,49%,72,55,30,157,79%,782,65%,auditory,2,Study more
ST-693,48,84,132,66%,32,52,44,128,64%,28,39,65,132,66%,31,65,32,128,64%,49,21,39,109,55%,55,31,36,122,61%,751,63%,auditory,5,Practice regularly
ST-694,62,36,98,49%,52,47,28,127,64%,35,42,36,113,57%,43,50,26,119,60%,75,38,27,140,70%,20,47,29,96,48%,693,58%,visual,1,Ask questions
ST-695,67,95,162,81%,23,35,54,112,56%,50,43,59,152,76%,62,62,27,151,76%,62,47,37,146,73%,21,58,25,104,52%,827,69%,visual,5,Practice regularly
ST-696,26,86,112,56%,49,77,20,146,73%,34,72,73,179,90%,64,22,37,123,62%,48,27,27,102,51%,50,52,37,139,70%,801,67%,visual,1,Join study group
ST-697,90,47,137,69%,29,24,49,102,51%,20,50,50,120,60%,55,70,37,162,81%,55,54,32,141,71%,38,48,38,124,62%,786,66%,auditory,2,Practice regularly
ST-698,77,65,142,71%,36,58,49,143,72%,25,73,64,162,81%,37,36,22,95,48%,57,47,21,125,63%,73,69,39,181,91%,848,71%,auditory,1,Practice regularly
ST-699,50,57,107,54%,39,51,44,134,67%,38,54,26,118,59%,46,77,26,149,75%,20,72,37,129,65%,29,72,23,124,62%,761,63%,auditory,3,Study more
ST-700,47,55,102,51%,54,20,53,127,64%,53,42,64,159,80%,71,30,22,123,62%,32,39,38,109,55%,26,55,26,107,54%,727,61%,kinesthetic,4,Study more
ST-701,48,43,91,46%,28,50,71,149,75%,56,54,71,181,91%,64,65,39,168,84%,60,67,36,163,82%,75,41,28,144,72%,896,75%,visual,3,Study more
ST-702,68,26,94,47%,50,34,62,146,73%,42,63,73,178,89%,23,55,23,101,51%,70,20,22,112,56%,46,21,34,101,51%,732,61%,visual,3,Ask questions
ST-703,62,47,109,55%,55,43,46,144,72%,35,38,64,137,69%,53,70,24,147,74%,25,76,37,138,69%,56,26,37,119,60%,794,66%,auditory,1,Practice regularly
ST-704,83,69,152,76%,45,30,55,130,65%,27,71,58,156,78%,27,52,36,115,58%,34,61,27,122,61%,30,28,30,88,44%,763,64%,auditory,3,Practice regularly
ST-705,37,79,116,58%,25,49,29,103,52%,59,26,23,108,54%,55,43,37,135,68%,39,58,27,124,62%,79,44,35,158,79%,744,62%,kinesthetic,3,Study more
ST-706,80,76,156,78%,47,43,36,126,63%,25,36,27,88,44%,29,34,22,85,43%,71,64,34,169,85%,69,46,28,143,72%,767,64%,visual,5,Study more
ST-707,54,77,131,66%,52,45,35,132,66%,20,74,68,162,81%,61,70,36,167,84%,23,77,39,139,70%,72,48,38,158,79%,889,74%,visual,5,Ask questions
ST-708,58,52,110,55%,48,40,77,165,83%,50,62,24,136,68%,34,53,25,112,56%,40,22,29,91,46%,41,67,20,128,64%,742,62%,auditory,3,Join study group
ST-709,24,83,107,54%,39,44,58,141,71%,52,55,57,164,82%,25,53,36,114,57%,79,42,34,155,78%,56,22,32,110,55%,791,66%,auditory,3,Join study group
ST-710,86,29,115,58%,45,78,58,181,91%,49,29,44,122,61%,53,32,31,116,58%,44,21,37,102,51%,75,25,36,136,68%,772,64%,kinesthetic,3,Study more
ST-711,83,26,109,55%,20,70,67,157,79%,59,55,64,178,89%,37,37,37,111,56%,38,63,20,121,61%,20,20,26,66,33%,742,62%,auditory,3,Study more
ST-712,93,97,190,95%,35,24,26,85,43%,31,31,60,122,61%,25,66,34,125,63%,38,64,22,124,62%,32,64,33,129,65%,775,65%,auditory,5,Study more
ST-713,25,77,102,51%,50,58,48,156,78%,51,28,33,112,56%,57,61,24,142,71%,49,59,35,143,72%,68,39,37,144,72%,799,67%,visual,4,Practice regularly
ST-714,29,93,122,61%,22,78,53,153,77%,28,29,28,85,43%,58,58,35,151,76%,37,70,31,138,69%,35,66,39,140,70%,789,66%,kinesthetic,4,Study more
ST-715,29,20,49,25%,37,49,40,126,63%,24,66,21,111,56%,54,69,28,151,76%,71,72,30,173,87%,73,32,35,140,70%,750,63%,kinesthetic,1,Join study group
ST-716,71,75,146,73%,23,63,40,126,63%,29,39,58,126,63%,35,73,39,147,74%,53,53,30,136,68%,68,28,36,132,66%,813,68%,visual,4,Practice regularly
ST-717,25,31,56,28%,29,49,52,130,65%,43,51,78,172,86%,57,75,23,155,78%,31,54,36,121,61%,70,44,22,136,68%,770,64%,visual,4,Join study group
ST-718,62,23,85,43%,54,77,38,169,85%,22,54,75,151,76%,35,69,22,126,63%,32,53,25,110,55%,60,36,29,125,63%,766,64%,kinesthetic,2,Study more
ST-719,49,32,81,41%,56,49,54,159,80%,37,47,45,129,65%,50,79,30,159,80%,32,69,27,128,64%,73,69,35,177,89%,833,69%,kinesthetic,1,Study more
ST-720,83,93,176,88%,31,54,64,149,75%,49,23,63,135,68%,57,73,39,169,85%,27,77,38,142,71%,51,58,20,129,65%,900,75%,kinesthetic,1,Ask questions
ST-721,35,45,80,40%,53,56,48,157,79%,47,53,42,142,71%,58,49,32,139,70%,57,61,24,142,71%,43,39,30,112,56%,772,64%,auditory,2,Study more
ST-722,82,35,117,59%,27,35,46,108,54%,52,64,66,182,91%,25,26,28,79,40%,73,47,25,145,73%,29,46,23,98,49%,729,61%,auditory,2,Practice regularly
ST-723,61,43,104,52%,25,20,20,65,33%,31,70,79,180,90%,75,25,39,139,70%,20,64,24,108,54%,62,72,30,164,82%,760,63%,auditory,3,Practice regularly
ST-724,62,42,104,52%,30,54,30,114,57%,23,33,63,119,60%,20,40,21,81,41%,60,49,26,135,68%,54,68,23,145,73%,698,58%,kinesthetic,1,Join study group
ST-725,24,58,82,41%,37,78,31,146,73%,20,38,78,136,68%,76,55,22,153,77%,41,29,30,100,50%,78,43,26,147,74%,764,64%,kinesthetic,1,Ask questions
ST-726,69,42,111,56%,46,44,55,145,73%,34,67,34,135,68%,30,62,37,129,65%,67,66,29,162,81%,55,24,23,102,51%,784,65%,kinesthetic,5,Study more
ST-727,30,60,90,45%,57,78,61,196,98%,29,36,39,104,52%,24,43,20,87,44%,38,78,30,146,73%,61,20,28,109,55%,732,61%,auditory,5,Practice regularly
ST-728,98,80,178,89%,54,46,48,148,74%,31,78,40,149,75%,36,56,31,123,62%,22,69,29,120,60%,52,20,22,94,47%,812,68%,visual,3,Practice regularly
ST-729,87,37,124,62%,41,78,24,143,72%,44,62,25,131,66%,54,51,39,144,72%,53,34,35,122,61%,34,22,35,91,46%,755,63%,auditory,5,Study more
ST-730,35,37,72,36%,57,37,70,164,82%,31,23,71,125,63%,74,78,35,187,94%,57,48,22,127,64%,71,61,38,170,85%,845,70%,auditory,3,Practice regularly
ST-731,89,71,160,80%,25,63,36,124,62%,20,45,48,113,57%,57,63,36,156,78%,44,25,36,105,53%,79,34,34,147,74%,805,67%,visual,2,Join study group
ST-732,98,80,178,89%,42,54,79,175,88%,40,76,28,144,72%,30,21,37,88,44%,57,73,26,156,78%,24,77,20,121,61%,862,72%,kinesthetic,5,Study more
ST-733,47,68,115,58%,55,69,63,187,94%,34,77,21,132,66%,23,38,20,81,41%,44,20,20,84,42%,31,35,32,98,49%,697,58%,auditory,4,Join study group
ST-734,85,39,124,62%,57,56,26,139,70%,26,46,41,113,57%,46,23,20,89,45%,71,31,20,122,61%,39,44,26,109,55%,696,58%,visual,5,Practice regularly
ST-735,79,94,173,87%,30,48,60,138,69%,54,72,55,181,91%,68,39,26,133,67%,44,70,26,140,70%,58,69,29,156,78%,921,77%,kinesthetic,3,Study more
ST-736,85,94,179,90%,30,24,50,104,52%,48,76,47,171,86%,41,48,30,119,60%,48,57,25,130,65%,70,24,38,132,66%,835,70%,auditory,1,Study more
ST-737,51,98,149,75%,21,30,36,87,44%,47,70,24,141,71%,63,78,20,161,81%,40,22,24,86,43%,73,29,20,122,61%,746,62%,kinesthetic,5,Study more
ST-738,93,77,170,85%,52,50,42,144,72%,51,43,37,131,66%,36,74,20,130,65%,27,67,33,127,64%,29,35,29,93,47%,795,66%,visual,1,Practice regularly
ST-739,64,89,153,77%,54,21,39,114,57%,54,55,65,174,87%,32,30,26,88,44%,20,75,28,123,62%,72,78,29,179,90%,831,69%,kinesthetic,4,Ask questions
ST-740,91,21,112,56%,44,60,37,141,71%,56,66,77,199,100%,32,62,27,121,61%,75,61,20,156,78%,39,37,27,103,52%,832,69%,kinesthetic,1,Join study group
ST-741,54,92,146,73%,26,51,77,154,77%,36,66,71,173,87%,32,36,28,96,48%,45,34,37,116,58%,61,26,21,108,54%,793,66%,visual,1,Join study group
ST-742,53,85,138,69%,36,71,67,174,87%,42,41,59,142,71%,64,55,33,152,76%,74,72,20,166,83%,77,32,37,146,73%,918,77%,auditory,5,Join study group
ST-743,78,47,125,63%,46,24,72,142,71%,48,46,24,118,59%,27,64,20,111,56%,65,21,29,115,58%,45,60,33,138,69%,749,62%,kinesthetic,1,Practice regularly
ST-744,84,25,109,55%,50,51,62,163,82%,56,27,38,121,61%,20,29,34,83,42%,77,59,26,162,81%,71,52,26,149,75%,787,66%,auditory,5,Study more
ST-745,83,26,109,55%,47,45,52,144,72%,54,54,63,171,86%,70,56,33,159,80%,39,58,29,126,63%,62,38,20,120,60%,829,69%,visual,1,Join study group
ST-746,77,57,134,67%,33,65,31,129,65%,38,66,58,162,81%,48,71,24,143,72%,25,36,37,98,49%,36,44,29,109,55%,775,65%,auditory,4,Study more
ST-747,51,53,104,52%,39,28,24,91,46%,44,58,66,168,84%,49,55,37,141,71%,64,21,33,118,59%,56,29,38,123,62%,745,62%,auditory,2,Study more
ST-748,23,53,76,38%,29,76,53,158,79%,38,53,36,127,64%,24,63,28,115,58%,38,42,23,103,52%,54,79,23,156,78%,735,61%,auditory,3,Ask questions
ST-749,31,68,99,50%,23,76,21,120,60%,30,32,65,127,64%,67,66,33,166,83%,21,38,25,84,42%,67,46,28,141,71%,737,61%,kinesthetic,5,Join study group
ST-750,21,61,82,41%,51,58,33,142,71%,36,61,70,167,84%,66,56,36,158,79%,76,20,32,128,64%,42,72,21,135,68%,812,68%,kinesthetic,3,Study more
ST-751,81,48,129,65%,27,53,63,143,72%,37,78,35,150,75%,38,52,31,121,61%,58,70,27,155,78%,39,51,28,118,59%,816,68%,auditory,1,Ask questions
ST-752,24,53,77,39%,47,79,45,171,86%,57,32,74,163,82%,23,49,35,107,54%,70,44,39,153,77%,78,36,31,145,73%,816,68%,auditory,3,Ask questions
ST-753,69,27,96,48%,40,28,22,90,45%,26,63,38,127,64%,35,43,37,115,58%,61,64,39,164,82%,72,73,21,166,83%,758,63%,visual,2,Ask questions
ST-754,23,44,67,34%,24,42,53,119,60%,21,51,28,100,50%,45,26,34,105,53%,72,57,34,163,82%,42,27,30,99,50%,653,54%,visual,1,Ask questions
ST-755,78,37,115,58%,48,57,56,161,81%,47,48,43,138,69%,47,24,22,93,47%,23,31,28,82,41%,48,66,33,147,74%,736,61%,visual,2,Join study group
ST-756,63,81,144,72%,26,77,21,124,62%,54,76,73,203,102%,38,75,31,144,72%,46,31,21,98,49%,69,24,31,124,62%,837,70%,kinesthetic,4,Ask questions
ST-757,51,28,79,40%,40,60,25,125,63%,50,31,43,124,62%,67,70,31,168,84%,71,53,28,152,76%,49,66,23,138,69%,786,66%,auditory,3,Study more
ST-758,50,31,81,41%,49,43,48,140,70%,22,72,58,152,76%,43,57,20,120,60%,53,75,29,157,79%,27,38,31,96,48%,746,62%,kinesthetic,2,Ask questions
ST-759,70,45,115,58%,55,28,71,154,77%,32,27,57,116,58%,68,72,30,170,85%,34,66,31,131,66%,34,63,28,125,63%,811,68%,kinesthetic,3,Practice regularly
ST-760,66,52,118,59%,30,54,34,118,59%,57,77,22,156,78%,67,76,23,166,83%,53,32,21,106,53%,47,46,34,127,64%,791,66%,kinesthetic,2,Study more
ST-761,63,64,127,64%,46,37,25,108,54%,49,63,51,163,82%,60,47,30,137,69%,49,39,31,119,60%,69,65,24,158,79%,812,68%,auditory,3,Study more
ST-762,87,60,147,74%,25,37,39,101,51%,53,67,41,161,81%,49,26,20,95,48%,38,62,29,129,65%,71,24,33,128,64%,761,63%,visual,3,Practice regularly
ST-763,93,63,156,78%,56,27,47,130,65%,57,24,64,145,73%,76,46,32,154,77%,61,24,38,123,62%,31,43,26,100,50%,808,67%,kinesthetic,4,Ask questions
ST-764,46,50,96,48%,58,37,69,164,82%,37,71,20,128,64%,30,26,26,82,41%,66,25,39,130,65%,72,20,37,129,65%,729,61%,visual,3,Study more
ST-765,24,64,88,44%,23,55,38,116,58%,33,67,60,160,80%,60,32,27,119,60%,30,30,37,97,49%,38,59,26,123,62%,703,59%,auditory,2,Practice regularly
ST-766,35,52,87,44%,38,40,75,153,77%,35,53,38,126,63%,75,72,30,177,89%,37,75,37,149,75%,71,50,39,160,80%,852,71%,visual,4,Practice regularly
ST-767,56,92,148,74%,28,22,36,86,43%,44,77,38,159,80%,25,52,25,102,51%,29,79,25,133,67%,20,65,35,120,60%,748,62%,visual,4,Ask questions
ST-768,59,58,117,59%,45,36,60,141,71%,28,36,41,105,53%,26,71,30,127,64%,25,24,24,73,37%,36,33,31,100,50%,663,55%,visual,5,Study more
ST-769,59,87,146,73%,38,56,38,132,66%,43,25,49,117,59%,69,62,20,151,76%,25,66,30,121,61%,33,55,22,110,55%,777,65%,auditory,3,Study more
ST-770,40,64,104,52%,45,41,44,130,65%,45,20,25,90,45%,64,53,37,154,77%,61,33,26,120,60%,43,53,39,135,68%,733,61%,visual,5,Practice regularly
ST-771,21,28,49,25%,57,68,66,191,96%,47,57,25,129,65%,67,50,25,142,71%,39,66,38,143,72%,55,40,33,128,64%,782,65%,auditory,2,Join study group
ST-772,45,31,76,38%,48,45,75,168,84%,35,51,23,109,55%,69,23,24,116,58%,47,55,38,140,70%,25,59,33,117,59%,726,61%,visual,4,Ask questions
ST-773,67,91,158,79%,39,48,74,161,81%,49,70,61,180,90%,36,46,33,115,58%,36,74,31,141,71%,78,69,29,176,88%,931,78%,auditory,5,Study more
ST-774,59,47,106,53%,52,47,39,138,69%,46,54,52,152,76%,48,54,39,141,71%,55,53,38,146,73%,38,61,39,138,69%,821,68%,kinesthetic,4,Join study group
ST-775,60,36,96,48%,53,40,70,163,82%,53,22,71,146,73%,65,27,24,116,58%,78,74,20,172,86%,23,28,36,87,44%,780,65%,kinesthetic,2,Practice regularly
ST-776,74,41,115,58%,47,60,72,179,90%,31,65,79,175,88%,67,64,33,164,82%,23,38,39,100,50%,25,23,22,70,35%,803,67%,kinesthetic,5,Join study group
ST-777,86,71,157,79%,24,31,32,87,44%,23,34,65,122,61%,27,76,24,127,64%,62,69,23,154,77%,78,38,21,137,69%,784,65%,visual,5,Ask questions
ST-778,40,78,118,59%,28,64,79,171,86%,54,29,32,115,58%,30,29,24,83,42%,48,28,31,107,54%,45,50,32,127,64%,721,60%,auditory,1,Join study group
ST-779,20,69,89,45%,50,75,76,201,101%,24,32,69,125,63%,23,74,29,126,63%,31,26,31,88,44%,73,63,33,169,85%,798,67%,kinesthetic,1,Practice regularly
ST-780,51,63,114,57%,25,56,29,110,55%,46,64,39,149,75%,42,59,21,122,61%,58,33,32,123,62%,47,72,39,158,79%,776,65%,visual,5,Ask questions
ST-781,40,80,120,60%,47,46,45,138,69%,41,30,33,104,52%,23,30,20,73,37%,33,58,36,127,64%,46,77,31,154,77%,716,60%,kinesthetic,4,Study more
ST-782,94,95,189,95%,46,30,67,143,72%,28,41,57,126,63%,66,39,23,128,64%,72,42,21,135,68%,20,37,24,81,41%,802,67%,auditory,2,Join study group
ST-783,24,53,77,39%,54,27,61,142,71%,46,25,26,97,49%,50,70,30,150,75%,47,58,37,142,71%,20,47,23,90,45%,698,58%,visual,1,Join study group
ST-784,62,80,142,71%,30,29,26,85,43%,45,26,32,103,52%,76,37,38,151,76%,72,72,39,183,92%,51,61,26,138,69%,802,67%,visual,3,Ask questions
ST-785,71,93,164,82%,31,68,59,158,79%,44,33,35,112,56%,34,33,36,103,52%,67,74,21,162,81%,51,63,32,146,73%,845,70%,auditory,4,Join study group
ST-786,52,90,142,71%,28,51,69,148,74%,57,45,59,161,81%,42,48,30,120,60%,58,56,32,146,73%,69,26,30,125,63%,842,70%,auditory,5,Study more
ST-787,90,88,178,89%,59,45,49,153,77%,21,51,44,116,58%,33,60,37,130,65%,20,60,22,102,51%,52,71,35,158,79%,837,70%,kinesthetic,2,Study more
ST-788,78,30,108,54%,32,30,66,128,64%,58,74,38,170,85%,40,32,25,97,49%,37,37,29,103,52%,73,79,20,172,86%,778,65%,visual,1,Join study group
ST-789,25,42,67,34%,22,42,33,97,49%,20,70,40,130,65%,72,72,38,182,91%,39,42,23,104,52%,72,63,23,158,79%,738,62%,auditory,1,Study more
ST-790,52,68,120,60%,59,67,30,156,78%,58,62,70,190,95%,23,32,31,86,43%,64,42,27,133,67%,26,68,23,117,59%,802,67%,kinesthetic,4,Join study group
ST-791,83,97,180,90%,59,37,36,132,66%,23,20,49,92,46%,21,24,37,82,41%,67,72,30,169,85%,23,39,24,86,43%,741,62%,kinesthetic,4,Ask questions
ST-792,81,85,166,83%,58,64,55,177,89%,25,79,32,136,68%,51,23,31,105,53%,73,24,34,131,66%,50,65,21,136,68%,851,71%,visual,3,Study more
ST-793,90,87,177,89%,37,62,51,150,75%,54,66,42,162,81%,63,61,25,149,75%,63,41,33,137,69%,29,23,34,86,43%,861,72%,visual,2,Practice regularly
ST-794,81,91,172,86%,50,66,34,150,75%,50,37,73,160,80%,55,32,35,122,61%,72,77,20,169,85%,63,37,26,126,63%,899,75%,auditory,5,Ask questions
ST-795,23,42,65,33%,35,76,56,167,84%,46,38,46,130,65%,79,64,37,180,90%,65,79,33,177,89%,64,36,22,122,61%,841,70%,auditory,2,Ask questions
ST-796,60,57,117,59%,29,32,69,130,65%,31,24,77,132,66%,62,53,21,136,68%,51,49,38,138,69%,67,22,30,119,60%,772,64%,visual,2,Ask questions
ST-797,76,23,99,50%,23,70,44,137,69%,57,36,66,159,80%,75,63,22,160,80%,72,21,24,117,59%,72,56,30,158,79%,830,69%,visual,4,Join study group
ST-798,85,44,129,65%,53,55,65,173,87%,54,30,75,159,80%,25,55,20,100,50%,71,66,39,176,88%,63,29,27,119,60%,856,71%,kinesthetic,2,Practice regularly
ST-799,76,23,99,50%,46,53,51,150,75%,29,67,71,167,84%,29,28,22,79,40%,60,78,32,170,85%,45,79,35,159,80%,824,69%,kinesthetic,1,Ask questions
ST-800,53,70,123,62%,37,52,47,136,68%,25,45,28,98,49%,22,49,24,95,48%,38,23,29,90,45%,57,28,26,111,56%,653,54%,visual,3,Study more
ST-801,43,49,92,46%,36,23,73,132,66%,45,39,47,131,66%,41,68,31,140,70%,70,29,26,125,63%,46,74,26,146,73%,766,64%,kinesthetic,2,Ask questions
ST-802,24,99,123,62%,49,20,78,147,74%,55,63,71,189,95%,21,30,20,71,36%,20,39,32,91,46%,61,43,38,142,71%,763,64%,kinesthetic,3,Study more
ST-803,73,41,114,57%,26,46,43,115,58%,25,56,39,120,60%,64,25,34,123,62%,31,55,30,116,58%,33,53,27,113,57%,701,58%,auditory,2,Practice regularly
ST-804,84,52,136,68%,28,58,49,135,68%,52,71,47,170,85%,39,35,22,96,48%,62,69,37,168,84%,62,49,39,150,75%,855,71%,auditory,3,Study more
ST-805,84,67,151,76%,48,66,63,177,89%,55,36,75,166,83%,50,26,28,104,52%,75,42,30,147,74%,41,61,21,123,62%,868,72%,auditory,5,Study more
ST-806,82,39,121,61%,25,26,21,72,36%,33,53,30,116,58%,36,65,37,138,69%,62,57,31,150,75%,75,28,31,134,67%,731,61%,visual,4,Study more
ST-807,78,72,150,75%,57,62,48,167,84%,28,21,35,84,42%,56,71,21,148,74%,41,52,39,132,66%,31,54,24,109,55%,790,66%,kinesthetic,2,Ask questions
ST-808,81,74,155,78%,54,23,68,145,73%,45,61,23,129,65%,50,47,28,125,63%,65,41,23,129,65%,54,65,23,142,71%,825,69%,kinesthetic,2,Join study group
ST-809,39,60,99,50%,53,27,53,133,67%,37,66,39,142,71%,25,64,23,112,56%,76,71,20,167,84%,51,70,22,143,72%,796,66%,auditory,5,Join study group
ST-810,27,36,63,32%,50,55,72,177,89%,28,42,42,112,56%,53,44,26,123,62%,59,68,26,153,77%,63,20,24,107,54%,735,61%,kinesthetic,5,Ask questions
ST-811,83,44,127,64%,29,47,26,102,51%,42,35,53,130,65%,69,43,29,141,71%,24,57,32,113,57%,46,42,26,114,57%,727,61%,kinesthetic,4,Study more
ST-812,38,82,120,60%,21,72,75,168,84%,58,42,78,178,89%,47,78,27,152,76%,50,66,28,144,72%,33,37,33,103,52%,865,72%,visual,3,Practice regularly
ST-813,57,70,127,64%,49,65,55,169,85%,48,33,40,121,61%,43,38,24,105,53%,62,20,27,109,55%,78,30,34,142,71%,773,64%,auditory,1,Join study group
ST-814,20,80,100,50%,53,41,36,130,65%,36,52,74,162,81%,63,53,20,136,68%,42,77,35,154,77%,40,44,30,114,57%,796,66%,visual,5,Study more
ST-815,97,66,163,82%,55,49,43,147,74%,58,53,33,144,72%,30,35,39,104,52%,76,33,29,138,69%,77,40,23,140,70%,836,70%,kinesthetic,3,Join study group
ST-816,28,53,81,41%,35,20,61,116,58%,41,55,51,147,74%,54,23,23,100,50%,27,24,22,73,37%,33,41,22,96,48%,613,51%,auditory,5,Practice regularly
ST-817,49,33,82,41%,47,69,72,188,94%,53,52,33,138,69%,33,22,25,80,40%,50,78,35,163,82%,68,63,36,167,84%,818,68%,visual,4,Practice regularly
ST-818,83,39,122,61%,33,48,79,160,80%,38,68,30,136,68%,27,79,33,139,70%,70,53,34,157,79%,66,21,33,120,60%,834,70%,kinesthetic,5,Join study group
ST-819,74,56,130,65%,32,36,69,137,69%,25,20,21,66,33%,40,36,31,107,54%,33,46,32,111,56%,54,37,33,124,62%,675,56%,visual,4,Join study group
ST-820,51,55,106,53%,24,54,70,148,74%,55,77,34,166,83%,48,36,28,112,56%,60,48,39,147,74%,23,76,27,126,63%,805,67%,auditory,2,Study more
ST-821,91,31,122,61%,36,48,55,139,70%,22,25,50,97,49%,32,66,35,133,67%,44,36,24,104,52%,30,68,34,132,66%,727,61%,auditory,3,Ask questions
ST-822,73,65,138,69%,21,47,53,121,61%,58,74,47,179,90%,73,30,30,133,67%,56,22,23,101,51%,33,40,33,106,53%,778,65%,auditory,3,Practice regularly
ST-823,27,30,57,29%,36,33,71,140,70%,39,32,46,117,59%,41,45,29,115,58%,23,58,38,119,60%,67,43,39,149,75%,697,58%,visual,1,Ask questions
ST-824,85,40,125,63%,28,64,51,143,72%,39,40,46,125,63%,59,56,24,139,70%,45,45,32,122,61%,36,74,22,132,66%,786,66%,auditory,4,Study more
ST-825,99,51,150,75%,49,68,79,196,98%,28,70,55,153,77%,27,62,22,111,56%,69,35,20,124,62%,62,67,21,150,75%,884,74%,auditory,4,Join study group
ST-826,87,26,113,57%,44,65,65,174,87%,27,63,43,133,67%,38,48,31,117,59%,30,67,29,126,63%,32,43,30,105,53%,768,64%,visual,4,Join study group
ST-827,83,42,125,63%,37,60,70,167,84%,25,21,38,84,42%,25,61,25,111,56%,39,70,31,140,70%,20,55,37,112,56%,739,62%,visual,4,Practice regularly
ST-828,73,85,158,79%,29,72,65,166,83%,29,29,38,96,48%,54,37,37,128,64%,58,64,32,154,77%,34,57,28,119,60%,821,68%,visual,5,Practice regularly
ST-829,60,98,158,79%,56,41,30,127,64%,55,78,60,193,97%,67,70,31,168,84%,77,23,31,131,66%,30,23,22,75,38%,852,71%,kinesthetic,1,Ask questions
ST-830,95,36,131,66%,45,55,45,145,73%,21,30,59,110,55%,68,54,35,157,79%,45,52,26,123,62%,67,40,35,142,71%,808,67%,auditory,1,Study more
ST-831,69,68,137,69%,54,62,63,179,90%,21,56,30,107,54%,33,79,24,136,68%,65,61,24,150,75%,46,59,38,143,72%,852,71%,auditory,4,Ask questions
ST-832,36,95,131,66%,40,52,30,122,61%,35,75,53,163,82%,71,54,38,163,82%,77,38,37,152,76%,36,37,23,96,48%,827,69%,kinesthetic,5,Join study group
ST-833,76,74,150,75%,40,32,21,93,47%,58,48,20,126,63%,43,62,23,128,64%,62,20,22,104,52%,54,52,39,145,73%,746,62%,kinesthetic,1,Ask questions
ST-834,73,94,167,84%,27,64,72,163,82%,43,63,53,159,80%,27,65,38,130,65%,54,74,21,149,75%,52,76,37,165,83%,933,78%,kinesthetic,1,Ask questions
ST-835,56,67,123,62%,27,53,36,116,58%,35,49,60,144,72%,51,41,26,118,59%,28,50,24,102,51%,42,76,33,151,76%,754,63%,auditory,2,Study more
ST-836,77,32,109,55%,33,37,54,124,62%,36,21,42,99,50%,53,31,23,107,54%,46,34,38,118,59%,26,40,36,102,51%,659,55%,visual,2,Ask questions
ST-837,90,92,182,91%,33,69,73,175,88%,43,31,39,113,57%,71,31,21,123,62%,62,45,22,129,65%,60,26,29,115,58%,837,70%,auditory,1,Ask questions
ST-838,27,47,74,37%,58,52,71,181,91%,35,52,52,139,70%,65,58,30,153,77%,26,20,20,66,33%,74,68,35,177,89%,790,66%,kinesthetic,1,Practice regularly
ST-839,20,38,58,29%,58,23,22,103,52%,47,71,58,176,88%,73,29,35,137,69%,35,64,23,122,61%,67,78,36,181,91%,777,65%,kinesthetic,3,Study more
ST-840,68,73,141,71%,23,31,29,83,42%,49,72,64,185,93%,37,72,30,139,70%,24,20,35,79,40%,76,49,29,154,77%,781,65%,auditory,2,Practice regularly
ST-841,75,90,165,83%,39,53,23,115,58%,52,56,72,180,90%,31,55,29,115,58%,52,42,31,125,63%,33,35,35,103,52%,803,67%,kinesthetic,3,Join study group
ST-842,38,99,137,69%,49,69,60,178,89%,36,40,49,125,63%,41,48,30,119,60%,26,25,29,80,40%,40,61,27,128,64%,767,64%,kinesthetic,5,Practice regularly
ST-843,44,52,96,48%,57,52,43,152,76%,27,41,26,94,47%,59,36,25,120,60%,58,68,32,158,79%,50,28,32,110,55%,730,61%,auditory,3,Join study group
ST-844,37,36,73,37%,43,71,78,192,96%,31,22,27,80,40%,60,78,39,177,89%,29,68,20,117,59%,59,60,22,141,71%,780,65%,visual,4,Practice regularly
ST-845,93,95,188,94%,34,34,65,133,67%,47,64,39,150,75%,72,36,31,139,70%,22,60,29,111,56%,52,21,27,100,50%,821,68%,auditory,2,Ask questions
ST-846,39,60,99,50%,40,30,47,117,59%,48,27,41,116,58%,72,79,21,172,86%,62,30,25,117,59%,35,77,23,135,68%,756,63%,auditory,4,Ask questions
ST-847,68,64,132,66%,37,46,74,157,79%,21,66,77,164,82%,68,68,32,168,84%,22,69,29,120,60%,54,75,32,161,81%,902,75%,kinesthetic,1,Join study group
ST-848,65,48,113,57%,52,41,41,134,67%,46,66,78,190,95%,56,60,39,155,78%,34,76,24,134,67%,51,36,22,109,55%,835,70%,visual,5,Study more
ST-849,24,31,55,28%,43,46,34,123,62%,46,28,78,152,76%,37,74,23,134,67%,58,57,33,148,74%,67,32,39,138,69%,750,63%,auditory,2,Practice regularly
ST-850,48,67,115,58%,58,45,74,177,89%,56,79,58,193,97%,79,31,26,136,68%,42,31,29,102,51%,53,54,24,131,66%,854,71%,visual,5,Study more
ST-851,58,74,132,66%,57,77,56,190,95%,52,78,69,199,100%,22,69,26,117,59%,50,71,23,144,72%,75,28,33,136,68%,918,77%,visual,5,Practice regularly
ST-852,23,78,101,51%,37,43,66,146,73%,49,59,27,135,68%,78,68,22,168,84%,59,32,26,117,59%,76,22,23,121,61%,788,66%,kinesthetic,3,Ask questions
ST-853,67,35,102,51%,48,42,64,154,77%,44,52,22,118,59%,46,47,20,113,57%,27,27,28,82,41%,71,74,33,178,89%,747,62%,visual,2,Study more
ST-854,51,92,143,72%,41,44,67,152,76%,21,24,34,79,40%,46,63,35,144,72%,56,77,37,170,85%,75,41,37,153,77%,841,70%,visual,4,Join study group
ST-855,29,46,75,38%,49,78,30,157,79%,36,71,72,179,90%,69,25,33,127,64%,65,79,23,167,84%,69,30,38,137,69%,842,70%,visual,5,Study more
ST-856,95,79,174,87%,28,37,31,96,48%,47,41,59,147,74%,77,31,25,133,67%,60,54,31,145,73%,66,77,37,180,90%,875,73%,visual,2,Practice regularly
ST-857,94,33,127,64%,53,39,72,164,82%,36,60,50,146,73%,47,39,21,107,54%,31,31,37,99,50%,41,46,30,117,59%,760,63%,visual,3,Ask questions
ST-858,45,86,131,66%,51,58,52,161,81%,43,62,31,136,68%,55,51,27,133,67%,20,74,35,129,65%,29,75,34,138,69%,828,69%,kinesthetic,2,Practice regularly
ST-859,50,98,148,74%,54,21,37,112,56%,43,38,72,153,77%,79,46,37,162,81%,62,69,33,164,82%,52,54,27,133,67%,872,73%,auditory,3,Ask questions
ST-860,77,55,132,66%,28,29,54,111,56%,54,23,25,102,51%,21,70,29,120,60%,34,56,27,117,59%,32,42,39,113,57%,695,58%,kinesthetic,4,Ask questions
ST-861,66,42,108,54%,59,42,58,159,80%,30,66,36,132,66%,23,72,28,123,62%,56,35,37,128,64%,61,33,30,124,62%,774,65%,visual,4,Join study group
ST-862,34,35,69,35%,44,68,49,161,81%,31,50,72,153,77%,63,44,28,135,68%,39,22,38,99,50%,77,48,32,157,79%,774,65%,visual,1,Join study group
ST-863,45,45,90,45%,38,79,38,155,78%,36,76,52,164,82%,54,30,30,114,57%,28,49,39,116,58%,36,33,28,97,49%,736,61%,visual,4,Study more
ST-864,33,80,113,57%,24,42,60,126,63%,31,27,34,92,46%,77,72,23,172,86%,36,20,23,79,40%,54,67,20,141,71%,723,60%,visual,1,Practice regularly
ST-865,24,28,52,26%,23,48,33,104,52%,31,66,24,121,61%,35,63,32,130,65%,20,43,24,87,44%,44,30,36,110,55%,604,50%,auditory,2,Ask questions
ST-866,86,41,127,64%,56,34,73,163,82%,21,42,47,110,55%,37,64,34,135,68%,27,24,26,77,39%,27,39,22,88,44%,700,58%,auditory,5,Ask questions
ST-867,53,36,89,45%,59,54,54,167,84%,44,62,44,150,75%,55,43,31,129,65%,70,74,38,182,91%,65,41,25,131,66%,848,71%,visual,3,Practice regularly
ST-868,71,67,138,69%,46,77,68,191,96%,59,72,46,177,89%,61,33,24,118,59%,35,45,36,116,58%,53,62,25,140,70%,880,73%,auditory,5,Practice regularly
ST-869,91,85,176,88%,24,38,54,116,58%,34,74,50,158,79%,61,73,21,155,78%,73,22,34,129,65%,31,39,26,96,48%,830,69%,visual,3,Practice regularly
ST-870,83,37,120,60%,38,62,70,170,85%,23,76,32,131,66%,64,39,39,142,71%,77,36,31,144,72%,65,42,22,129,65%,836,70%,kinesthetic,2,Ask questions
ST-871,39,76,115,58%,47,41,66,154,77%,30,20,44,94,47%,59,77,35,171,86%,41,72,29,142,71%,33,56,21,110,55%,786,66%,visual,1,Ask questions
ST-872,30,83,113,57%,43,43,24,110,55%,54,69,28,151,76%,75,73,24,172,86%,78,66,22,166,83%,30,60,22,112,56%,824,69%,visual,5,Practice regularly
ST-873,65,56,121,61%,29,25,44,98,49%,54,65,59,178,89%,65,40,34,139,70%,50,59,38,147,74%,74,40,26,140,70%,823,69%,kinesthetic,5,Study more
ST-874,88,26,114,57%,29,28,62,119,60%,33,46,48,127,64%,32,29,23,84,42%,37,44,26,107,54%,46,38,28,112,56%,663,55%,auditory,3,Study more
ST-875,58,81,139,70%,54,61,37,152,76%,29,49,75,153,77%,68,46,37,151,76%,40,49,22,111,56%,29,78,29,136,68%,842,70%,auditory,5,Study more
ST-876,91,36,127,64%,52,60,52,164,82%,33,22,61,116,58%,27,47,27,101,51%,76,68,39,183,92%,42,55,25,122,61%,813,68%,visual,2,Join study group
ST-877,92,93,185,93%,36,63,56,155,78%,41,31,63,135,68%,51,35,24,110,55%,50,54,37,141,71%,35,35,36,106,53%,832,69%,visual,2,Join study group
ST-878,21,79,100,50%,50,39,32,121,61%,35,63,43,141,71%,59,32,32,123,62%,63,24,39,126,63%,52,32,22,106,53%,717,60%,kinesthetic,1,Join study group
ST-879,38,89,127,64%,38,57,57,152,76%,31,37,62,130,65%,34,25,36,95,48%,69,38,22,129,65%,30,42,24,96,48%,729,61%,visual,5,Practice regularly
ST-880,60,21,81,41%,54,60,22,136,68%,29,67,49,145,73%,74,49,35,158,79%,50,68,34,152,76%,71,65,36,172,86%,844,70%,visual,4,Ask questions
ST-881,64,34,98,49%,52,31,31,114,57%,46,45,29,120,60%,55,77,33,165,83%,71,72,28,171,86%,72,53,34,159,80%,827,69%,auditory,3,Practice regularly
ST-882,61,39,100,50%,58,34,50,142,71%,41,30,30,101,51%,49,48,25,122,61%,54,75,32,161,81%,57,52,38,147,74%,773,64%,auditory,1,Join study group
ST-883,86,28,114,57%,24,79,69,172,86%,32,69,56,157,79%,36,73,33,142,71%,74,30,31,135,68%,33,43,29,105,53%,825,69%,visual,1,Join study group
ST-884,41,98,139,70%,51,31,21,103,52%,43,21,41,105,53%,27,55,24,106,53%,36,34,29,99,50%,25,27,33,85,43%,637,53%,auditory,3,Practice regularly
ST-885,37,81,118,59%,21,49,79,149,75%,28,70,69,167,84%,21,49,27,97,49%,35,61,33,129,65%,20,51,39,110,55%,770,64%,kinesthetic,2,Ask questions
ST-886,60,29,89,45%,35,75,58,168,84%,55,44,25,124,62%,47,31,36,114,57%,70,49,25,144,72%,66,64,38,168,84%,807,67%,auditory,2,Join study group
ST-887,27,21,48,24%,50,77,25,152,76%,33,31,49,113,57%,69,59,33,161,81%,36,21,36,93,47%,57,44,38,139,70%,706,59%,auditory,2,Practice regularly
ST-888,83,59,142,71%,26,35,29,90,45%,44,44,77,165,83%,26,75,31,132,66%,68,48,31,147,74%,58,77,23,158,79%,834,70%,kinesthetic,2,Join study group
ST-889,49,41,90,45%,59,25,61,145,73%,43,73,53,169,85%,56,45,36,137,69%,46,33,31,110,55%,78,20,20,118,59%,769,64%,kinesthetic,3,Join study group
ST-890,75,68,143,72%,34,22,62,118,59%,33,62,37,132,66%,33,57,20,110,55%,75,56,22,153,77%,65,45,20,130,65%,786,66%,auditory,4,Join study group
ST-891,28,68,96,48%,36,51,58,145,73%,59,67,37,163,82%,53,40,33,126,63%,43,34,29,106,53%,66,40,23,129,65%,765,64%,kinesthetic,5,Ask questions
ST-892,23,55,78,39%,28,52,35,115,58%,51,25,44,120,60%,25,56,34,115,58%,77,74,38,189,95%,57,60,21,138,69%,755,63%,visual,1,Study more
ST-893,36,32,68,34%,51,40,50,141,71%,24,76,26,126,63%,31,29,27,87,44%,41,27,32,100,50%,46,71,39,156,78%,678,57%,kinesthetic,3,Study more
ST-894,21,75,96,48%,53,67,69,189,95%,51,27,64,142,71%,67,60,26,153,77%,64,21,33,118,59%,34,56,38,128,64%,826,69%,auditory,4,Practice regularly
ST-895,65,96,161,81%,35,47,44,126,63%,21,67,35,123,62%,40,30,25,95,48%,51,75,31,157,79%,30,40,24,94,47%,756,63%,visual,1,Study more
ST-896,73,26,99,50%,36,63,23,122,61%,52,27,27,106,53%,50,64,24,138,69%,31,27,31,89,45%,51,34,26,111,56%,665,55%,auditory,2,Study more
ST-897,53,99,152,76%,54,29,63,146,73%,35,33,24,92,46%,45,77,35,157,79%,49,76,28,153,77%,41,27,35,103,52%,803,67%,auditory,1,Ask questions
ST-898,70,27,97,49%,47,39,63,149,75%,36,34,71,141,71%,61,65,31,157,79%,34,58,23,115,58%,59,23,29,111,56%,770,64%,visual,2,Join study group
ST-899,25,38,63,32%,23,71,36,130,65%,45,39,55,139,70%,53,47,28,128,64%,67,56,33,156,78%,76,55,39,170,85%,786,66%,visual,3,Practice regularly
ST-900,87,85,172,86%,34,73,63,170,85%,56,71,24,151,76%,63,60,35,158,79%,31,42,38,111,56%,78,55,32,165,83%,927,77%,kinesthetic,1,Join study group
ST-901,62,51,113,57%,26,47,30,103,52%,25,23,22,70,35%,52,45,23,120,60%,39,43,35,117,59%,30,36,28,94,47%,617,51%,kinesthetic,1,Ask questions
ST-902,79,71,150,75%,22,29,66,117,59%,54,58,66,178,89%,32,49,23,104,52%,52,29,26,107,54%,56,49,22,127,64%,783,65%,visual,3,Join study group
ST-903,90,31,121,61%,34,27,61,122,61%,35,43,36,114,57%,69,30,30,129,65%,71,40,32,143,72%,53,45,33,131,66%,760,63%,auditory,3,Practice regularly
ST-904,68,38,106,53%,29,21,68,118,59%,56,25,41,122,61%,65,22,38,125,63%,66,39,38,143,72%,28,71,35,134,67%,748,62%,visual,3,Ask questions
ST-905,69,23,92,46%,54,30,26,110,55%,48,20,47,115,58%,32,45,38,115,58%,31,37,33,101,51%,46,79,22,147,74%,680,57%,auditory,2,Practice regularly
ST-906,46,70,116,58%,27,35,23,85,43%,58,42,31,131,66%,67,37,39,143,72%,58,46,38,142,71%,60,25,32,117,59%,734,61%,visual,3,Ask questions
ST-907,67,39,106,53%,37,68,20,125,63%,36,27,63,126,63%,52,52,21,125,63%,40,53,25,118,59%,22,42,34,98,49%,698,58%,auditory,1,Ask questions
ST-908,67,68,135,68%,59,20,70,149,75%,43,73,48,164,82%,35,74,33,142,71%,75,24,36,135,68%,29,44,34,107,54%,832,69%,visual,4,Practice regularly
ST-909,82,46,128,64%,55,67,53,175,88%,41,66,25,132,66%,30,28,39,97,49%,27,52,28,107,54%,23,32,32,87,44%,726,61%,kinesthetic,1,Join study group
ST-910,94,26,120,60%,35,42,74,151,76%,29,24,58,111,56%,43,63,31,137,69%,60,44,33,137,69%,20,20,30,70,35%,726,61%,kinesthetic,4,Join study group
ST-911,93,75,168,84%,31,50,77,158,79%,31,29,48,108,54%,25,36,32,93,47%,26,66,35,127,64%,58,34,26,118,59%,772,64%,auditory,2,Study more
ST-912,60,38,98,49%,24,32,66,122,61%,39,67,79,185,93%,32,32,33,97,49%,33,48,29,110,55%,49,67,33,149,75%,761,63%,kinesthetic,2,Ask questions
ST-913,38,98,136,68%,52,48,31,131,66%,42,25,61,128,64%,62,76,24,162,81%,62,36,34,132,66%,25,68,22,115,58%,804,67%,visual,3,Study more
ST-914,77,79,156,78%,42,44,54,140,70%,58,79,67,204,102%,79,46,23,148,74%,49,79,30,158,79%,44,29,32,105,53%,911,76%,auditory,1,Study more
ST-915,88,70,158,79%,37,76,75,188,94%,26,51,35,112,56%,71,60,27,158,79%,49,27,25,101,51%,42,36,38,116,58%,833,69%,auditory,4,Study more
ST-916,24,24,48,24%,42,69,75,186,93%,42,59,70,171,86%,24,59,38,121,61%,42,43,25,110,55%,53,24,36,113,57%,749,62%,kinesthetic,2,Ask questions
ST-917,80,39,119,60%,33,22,26,81,41%,30,34,39,103,52%,52,52,29,133,67%,53,49,20,122,61%,38,31,39,108,54%,666,56%,kinesthetic,3,Study more
ST-918,60,21,81,41%,46,60,55,161,81%,52,53,24,129,65%,34,23,29,86,43%,73,68,28,169,85%,33,61,28,122,61%,748,62%,visual,1,Join study group
ST-919,22,69,91,46%,42,70,45,157,79%,51,50,38,139,70%,31,71,38,140,70%,53,46,25,124,62%,51,22,36,109,55%,760,63%,auditory,5,Study more
ST-920,26,23,49,25%,24,29,61,114,57%,28,76,49,153,77%,60,32,27,119,60%,63,22,38,123,62%,47,53,25,125,63%,683,57%,auditory,1,Join study group
ST-921,63,60,123,62%,43,75,41,159,80%,32,50,73,155,78%,38,66,31,135,68%,58,71,21,150,75%,39,78,23,140,70%,862,72%,auditory,1,Practice regularly
ST-922,78,61,139,70%,40,57,65,162,81%,24,35,54,113,57%,30,54,21,105,53%,38,57,29,124,62%,65,58,20,143,72%,786,66%,auditory,3,Join study group
ST-923,25,87,112,56%,59,66,47,172,86%,22,61,75,158,79%,44,50,39,133,67%,50,67,38,155,78%,59,67,33,159,80%,889,74%,visual,5,Practice regularly
ST-924,96,32,128,64%,23,62,65,150,75%,37,37,28,102,51%,30,64,35,129,65%,54,57,26,137,69%,42,40,28,110,55%,756,63%,visual,5,Practice regularly
ST-925,78,83,161,81%,21,38,49,108,54%,30,27,25,82,41%,47,32,27,106,53%,59,39,36,134,67%,65,33,36,134,67%,725,60%,auditory,3,Practice regularly
ST-926,95,25,120,60%,26,48,48,122,61%,52,47,78,177,89%,31,34,35,100,50%,69,34,30,133,67%,20,76,35,131,66%,783,65%,kinesthetic,4,Join study group
ST-927,21,32,53,27%,26,25,22,73,37%,42,49,52,143,72%,40,71,26,137,69%,49,44,28,121,61%,38,33,23,94,47%,621,52%,kinesthetic,2,Practice regularly
ST-928,67,80,147,74%,32,78,64,174,87%,55,49,29,133,67%,46,28,32,106,53%,76,72,34,182,91%,51,66,26,143,72%,885,74%,visual,1,Ask questions
ST-929,72,37,109,55%,41,67,56,164,82%,45,65,51,161,81%,21,54,37,112,56%,28,32,29,89,45%,33,28,23,84,42%,719,60%,visual,5,Ask questions
ST-930,52,40,92,46%,24,24,56,104,52%,55,76,39,170,85%,50,54,28,132,66%,29,72,27,128,64%,75,31,24,130,65%,756,63%,visual,3,Practice regularly
ST-931,40,42,82,41%,50,39,57,146,73%,42,66,22,130,65%,55,26,36,117,59%,30,70,24,124,62%,65,60,27,152,76%,751,63%,kinesthetic,1,Join study group
ST-932,89,37,126,63%,21,34,64,119,60%,27,51,56,134,67%,63,22,27,112,56%,38,40,23,101,51%,46,58,28,132,66%,724,60%,auditory,4,Join study group
ST-933,51,35,86,43%,22,77,33,132,66%,42,66,76,184,92%,77,34,24,135,68%,34,68,32,134,67%,48,22,28,98,49%,769,64%,visual,3,Practice regularly
ST-934,69,85,154,77%,25,33,35,93,47%,38,34,20,92,46%,52,26,36,114,57%,53,37,23,113,57%,79,78,28,185,93%,751,63%,auditory,2,Study more
ST-935,93,78,171,86%,26,66,58,150,75%,27,29,46,102,51%,35,67,26,128,64%,59,56,35,150,75%,70,67,37,174,87%,875,73%,visual,2,Practice regularly
ST-936,30,73,103,52%,59,40,39,138,69%,29,27,40,96,48%,59,46,28,133,67%,20,69,33,122,61%,37,63,31,131,66%,723,60%,auditory,4,Ask questions
ST-937,38,79,117,59%,58,23,39,120,60%,47,41,65,153,77%,27,39,26,92,46%,78,74,36,188,94%,56,22,23,101,51%,771,64%,kinesthetic,1,Study more
ST-938,81,36,117,59%,43,35,38,116,58%,51,52,61,164,82%,56,49,37,142,71%,67,25,21,113,57%,55,39,39,133,67%,785,65%,auditory,3,Practice regularly
ST-939,28,43,71,36%,28,75,78,181,91%,29,57,33,119,60%,35,72,20,127,64%,36,52,34,122,61%,23,25,36,84,42%,704,59%,kinesthetic,1,Ask questions
ST-940,69,51,120,60%,45,41,56,142,71%,20,57,61,138,69%,43,21,27,91,46%,42,33,31,106,53%,55,35,23,113,57%,710,59%,auditory,1,Ask questions
ST-941,87,31,118,59%,45,75,22,142,71%,33,22,60,115,58%,46,56,28,130,65%,46,23,24,93,47%,76,43,23,142,71%,740,62%,kinesthetic,2,Ask questions
ST-942,39,38,77,39%,32,64,51,147,74%,27,73,68,168,84%,70,36,20,126,63%,59,79,32,170,85%,40,55,23,118,59%,806,67%,auditory,5,Ask questions
ST-943,20,60,80,40%,25,31,58,114,57%,54,55,67,176,88%,50,64,21,135,68%,73,39,31,143,72%,54,39,32,125,63%,773,64%,visual,5,Ask questions
ST-944,69,53,122,61%,56,37,76,169,85%,22,39,45,106,53%,36,23,33,92,46%,68,37,30,135,68%,58,76,26,160,80%,784,65%,auditory,3,Ask questions
ST-945,28,74,102,51%,37,70,64,171,86%,21,57,32,110,55%,60,20,21,101,51%,22,66,30,118,59%,45,65,21,131,66%,733,61%,auditory,5,Join study group
ST-946,82,56,138,69%,57,51,36,144,72%,50,76,64,190,95%,32,67,34,133,67%,27,68,32,127,64%,49,53,21,123,62%,855,71%,visual,1,Join study group
ST-947,81,33,114,57%,53,20,64,137,69%,48,65,57,170,85%,66,77,21,164,82%,78,34,25,137,69%,71,38,20,129,65%,851,71%,kinesthetic,1,Join study group
ST-948,47,38,85,43%,42,53,49,144,72%,57,48,27,132,66%,67,44,25,136,68%,74,36,22,132,66%,28,25,27,80,40%,709,59%,kinesthetic,5,Join study group
ST-949,66,66,132,66%,33,79,26,138,69%,33,31,28,92,46%,36,23,31,90,45%,47,36,35,118,59%,72,47,33,152,76%,722,60%,kinesthetic,1,Study more
ST-950,83,87,170,85%,42,26,62,130,65%,41,64,23,128,64%,53,52,35,140,70%,56,50,23,129,65%,50,37,28,115,58%,812,68%,auditory,4,Study more
ST-951,61,64,125,63%,47,66,27,140,70%,54,26,69,149,75%,20,35,33,88,44%,37,77,33,147,74%,41,51,35,127,64%,776,65%,kinesthetic,2,Join study group
ST-952,46,45,91,46%,53,71,41,165,83%,50,62,47,159,80%,21,64,34,119,60%,58,61,35,154,77%,71,59,36,166,83%,854,71%,visual,5,Join study group
ST-953,20,73,93,47%,26,68,31,125,63%,38,64,25,127,64%,61,31,30,122,61%,46,57,34,137,69%,51,23,34,108,54%,712,59%,kinesthetic,2,Join study group
ST-954,76,66,142,71%,54,62,24,140,70%,41,28,47,116,58%,26,22,29,77,39%,66,58,33,157,79%,47,67,35,149,75%,781,65%,kinesthetic,1,Practice regularly
ST-955,29,68,97,49%,20,60,36,116,58%,25,41,48,114,57%,38,72,33,143,72%,28,49,23,100,50%,76,31,37,144,72%,714,60%,kinesthetic,2,Join study group
ST-956,81,63,144,72%,33,61,27,121,61%,58,52,67,177,89%,49,62,20,131,66%,27,29,35,91,46%,68,36,22,126,63%,790,66%,kinesthetic,5,Ask questions
ST-957,26,37,63,32%,29,45,36,110,55%,40,20,69,129,65%,47,72,31,150,75%,37,65,27,129,65%,62,29,39,130,65%,711,59%,visual,4,Ask questions
ST-958,40,88,128,64%,20,70,79,169,85%,21,34,53,108,54%,27,21,33,81,41%,23,76,34,133,67%,53,79,37,169,85%,788,66%,auditory,2,Ask questions
ST-959,25,25,50,25%,45,44,57,146,73%,58,22,54,134,67%,73,43,36,152,76%,73,31,28,132,66%,50,54,37,141,71%,755,63%,kinesthetic,5,Join study group
ST-960,52,83,135,68%,38,58,50,146,73%,46,75,29,150,75%,54,41,34,129,65%,26,79,20,125,63%,34,23,22,79,40%,764,64%,auditory,3,Practice regularly
ST-961,88,66,154,77%,49,37,71,157,79%,36,73,57,166,83%,61,45,21,127,64%,74,59,30,163,82%,43,42,35,120,60%,887,74%,visual,3,Ask questions
ST-962,48,75,123,62%,31,62,73,166,83%,41,60,53,154,77%,65,79,22,166,83%,71,53,24,148,74%,73,55,27,155,78%,912,76%,kinesthetic,5,Study more
ST-963,69,53,122,61%,46,47,46,139,70%,30,44,53,127,64%,72,69,24,165,83%,42,30,37,109,55%,60,28,27,115,58%,777,65%,kinesthetic,2,Practice regularly
ST-964,65,80,145,73%,52,62,51,165,83%,46,65,38,149,75%,72,49,36,157,79%,44,62,34,140,70%,74,21,33,128,64%,884,74%,kinesthetic,2,Practice regularly
ST-965,75,73,148,74%,31,60,50,141,71%,56,63,43,162,81%,50,32,30,112,56%,70,78,30,178,89%,40,79,29,148,74%,889,74%,kinesthetic,3,Join study group
ST-966,70,50,120,60%,31,46,72,149,75%,56,30,55,141,71%,48,50,27,125,63%,71,67,26,164,82%,78,25,32,135,68%,834,70%,auditory,2,Join study group
ST-967,27,32,59,30%,51,38,75,164,82%,40,63,40,143,72%,32,75,30,137,69%,34,60,36,130,65%,37,62,20,119,60%,752,63%,visual,4,Ask questions
ST-968,89,93,182,91%,30,79,38,147,74%,44,50,75,169,85%,32,63,21,116,58%,61,30,29,120,60%,38,76,28,142,71%,876,73%,auditory,1,Join study group
ST-969,93,73,166,83%,56,31,62,149,75%,54,58,20,132,66%,40,36,30,106,53%,78,32,28,138,69%,63,68,29,160,80%,851,71%,auditory,2,Join study group
ST-970,61,27,88,44%,43,74,25,142,71%,27,30,50,107,54%,58,58,23,139,70%,21,43,39,103,52%,67,75,36,178,89%,757,63%,kinesthetic,4,Ask questions
ST-971,77,43,120,60%,22,69,73,164,82%,25,31,23,79,40%,54,73,25,152,76%,41,52,39,132,66%,36,69,36,141,71%,788,66%,auditory,5,Ask questions
ST-972,38,39,77,39%,30,70,61,161,81%,50,72,47,169,85%,26,73,24,123,62%,20,40,29,89,45%,74,74,33,181,91%,800,67%,auditory,1,Practice regularly
ST-973,93,51,144,72%,59,47,67,173,87%,46,48,41,135,68%,37,64,32,133,67%,52,29,38,119,60%,78,67,25,170,85%,874,73%,kinesthetic,5,Practice regularly
ST-974,78,53,131,66%,20,44,44,108,54%,24,24,38,86,43%,77,42,24,143,72%,33,56,33,122,61%,49,72,28,149,75%,739,62%,kinesthetic,2,Study more
ST-975,54,65,119,60%,46,74,61,181,91%,45,58,49,152,76%,34,30,20,84,42%,30,33,24,87,44%,68,78,28,174,87%,797,66%,auditory,5,Practice regularly
ST-976,80,97,177,89%,28,72,65,165,83%,45,57,41,143,72%,21,73,24,118,59%,22,68,24,114,57%,42,26,39,107,54%,824,69%,visual,1,Study more
ST-977,32,35,67,34%,54,73,27,154,77%,59,28,29,116,58%,62,70,27,159,80%,71,75,39,185,93%,52,73,35,160,80%,841,70%,visual,3,Practice regularly
ST-978,91,56,147,74%,26,59,56,141,71%,22,56,33,111,56%,63,77,31,171,86%,40,78,21,139,70%,57,63,20,140,70%,849,71%,auditory,4,Practice regularly
ST-979,63,26,89,45%,45,50,55,150,75%,40,47,67,154,77%,50,46,24,120,60%,79,32,34,145,73%,31,68,21,120,60%,778,65%,kinesthetic,2,Study more
ST-980,67,41,108,54%,21,55,24,100,50%,38,65,72,175,88%,55,36,34,125,63%,64,77,29,170,85%,62,48,33,143,72%,821,68%,auditory,1,Study more
ST-981,32,39,71,36%,43,46,56,145,73%,38,68,61,167,84%,32,77,33,142,71%,52,29,24,105,53%,37,78,28,143,72%,773,64%,kinesthetic,3,Study more
ST-982,37,61,98,49%,40,43,26,109,55%,57,22,26,105,53%,53,48,26,127,64%,48,29,34,111,56%,40,55,28,123,62%,673,56%,auditory,3,Ask questions
ST-983,53,63,116,58%,27,48,71,146,73%,35,51,42,128,64%,57,26,32,115,58%,79,53,36,168,84%,46,21,35,102,51%,775,65%,visual,5,Ask questions
ST-984,56,71,127,64%,40,68,40,148,74%,39,36,62,137,69%,65,30,24,119,60%,22,39,27,88,44%,76,35,39,150,75%,769,64%,visual,5,Join study group
ST-985,88,59,147,74%,58,53,59,170,85%,59,69,54,182,91%,20,68,34,122,61%,75,70,35,180,90%,55,72,26,153,77%,954,80%,visual,3,Practice regularly
ST-986,93,27,120,60%,37,64,45,146,73%,27,68,37,132,66%,28,58,24,110,55%,30,28,29,87,44%,71,69,36,176,88%,771,64%,auditory,5,Study more
ST-987,77,55,132,66%,44,33,68,145,73%,34,42,55,131,66%,31,20,34,85,43%,75,64,29,168,84%,79,28,39,146,73%,807,67%,kinesthetic,5,Join study group
ST-988,84,93,177,89%,31,73,40,144,72%,58,22,78,158,79%,39,23,38,100,50%,24,35,27,86,43%,22,48,34,104,52%,769,64%,auditory,5,Ask questions
ST-989,59,60,119,60%,21,63,54,138,69%,41,70,26,137,69%,65,20,34,119,60%,59,73,26,158,79%,66,28,33,127,64%,798,67%,auditory,3,Join study group
ST-990,60,96,156,78%,26,74,55,155,78%,29,37,34,100,50%,59,79,23,161,81%,52,69,26,147,74%,60,34,38,132,66%,851,71%,auditory,3,Join study group
ST-991,82,42,124,62%,39,61,49,149,75%,40,41,52,133,67%,25,53,28,106,53%,45,43,35,123,62%,51,42,30,123,62%,758,63%,visual,3,Ask questions
ST-992,89,72,161,81%,37,49,22,108,54%,46,37,52,135,68%,72,63,27,162,81%,29,42,36,107,54%,48,72,35,155,78%,828,69%,visual,5,Study more
ST-993,77,58,135,68%,20,53,28,101,51%,26,76,78,180,90%,36,66,36,138,69%,64,59,28,151,76%,79,38,22,139,70%,844,70%,visual,2,Join study group
ST-994,47,25,72,36%,36,33,45,114,57%,33,77,41,151,76%,28,38,28,94,47%,71,24,37,132,66%,41,30,30,101,51%,664,55%,auditory,5,Practice regularly
ST-995,41,80,121,61%,43,45,21,109,55%,26,25,35,86,43%,49,68,31,148,74%,27,24,21,72,36%,24,62,38,124,62%,660,55%,kinesthetic,5,Study more
ST-996,38,66,104,52%,30,61,48,139,70%,22,29,78,129,65%,49,31,24,104,52%,58,31,30,119,60%,72,52,22,146,73%,741,62%,auditory,3,Ask questions
ST-997,38,50,88,44%,57,65,64,186,93%,25,47,67,139,70%,21,70,33,124,62%,38,51,21,110,55%,78,57,35,170,85%,817,68%,visual,2,Study more
ST-998,91,50,141,71%,20,48,49,117,59%,23,51,36,110,55%,56,23,20,99,50%,59,75,26,160,80%,56,64,39,159,80%,786,66%,auditory,3,Ask questions
ST-999,20,32,52,26%,37,43,31,111,56%,41,21,74,136,68%,34,23,24,81,41%,64,74,20,158,79%,23,57,32,112,56%,650,54%,auditory,3,Practice regularly
ST-1000,26,92,118,59%,21,66,50,137,69%,42,23,71,136,68%,75,65,32,172,86%,52,38,31,121,61%,36,38,32,106,53%,790,66%,auditory,2,Ask questions
